//MAP CONVERTED BY dmm2tgm.py THIS HEADER COMMENT PREVENTS RECONVERSION, DO NOT REMOVE
"a" = (
/turf/open/floor/mineral/plastitanium,
/area/shuttle/pod_shuttle)
"c" = (
/obj/structure/chair/fancy/shuttle{
	dir = 1
	},
/obj/effect/turf_decal/stripes/line{
	dir = 1
	},
/turf/open/floor/mineral/plastitanium,
/area/shuttle/pod_shuttle)
"f" = (
/obj/effect/turf_decal/stripes/line{
	dir = 1
	},
/turf/open/floor/mineral/plastitanium,
/area/shuttle/pod_shuttle)
"g" = (
/obj/structure/fans/tiny,
/obj/effect/turf_decal/stripes/line{
	dir = 8
	},
/obj/effect/turf_decal/stripes/line{
	dir = 4
	},
/obj/machinery/door/airlock/centcom{
	name = "Shuttle Airlock"
	},
/obj/docking_port/mobile{
	dir = 8;
	dwidth = 4;
	height = 6;
	shuttle_object_type = /datum/orbital_object/shuttle/custom_shuttle;
	width = 10
	},
/turf/open/floor/mineral/plastitanium/red,
/area/shuttle/pod_shuttle)
"i" = (
/obj/structure/chair/fancy/shuttle{
	dir = 8
	},
/obj/effect/turf_decal/stripes/line{
	dir = 9
	},
/obj/machinery/light/small{
	dir = 4
	},
/turf/open/floor/mineral/plastitanium/red,
/area/shuttle/pod_shuttle)
"l" = (
/obj/structure/chair/fancy/shuttle{
	dir = 4
	},
/obj/effect/turf_decal/stripes/line{
	dir = 5
	},
/obj/machinery/light/small{
	dir = 8
	},
/turf/open/floor/mineral/plastitanium/red,
/area/shuttle/pod_shuttle)
"n" = (
/turf/template_noop,
/area/template_noop)
"o" = (
/obj/structure/chair/fancy/shuttle{
	dir = 8
	},
/obj/effect/turf_decal/stripes/line{
	dir = 10
	},
/turf/open/floor/mineral/plastitanium/red,
/area/shuttle/pod_shuttle)
"p" = (
/obj/effect/turf_decal/bot,
/obj/structure/closet/crate,
/obj/effect/spawner/lootdrop/maintenance,
/obj/structure/cable/yellow{
	icon_state = "1-2"
	},
/obj/item/stack/sheet/mineral/plasma/five,
/turf/open/floor/mineral/plastitanium,
/area/shuttle/pod_shuttle)
"q" = (
/obj/effect/spawner/structure/window/plastitanium,
/turf/open/floor/plating,
/area/shuttle/pod_shuttle)
"s" = (
/obj/effect/turf_decal/bot,
/obj/structure/closet/crate,
/obj/effect/spawner/lootdrop/maintenance/three,
/obj/structure/cable/yellow{
	icon_state = "1-2"
	},
/obj/item/pickaxe/emergency,
/turf/open/floor/mineral/plastitanium,
/area/shuttle/pod_shuttle)
"u" = (
/obj/effect/turf_decal/stripes/line{
	dir = 1
	},
/obj/machinery/atmospherics/pipe/manifold/purple/visible{
	dir = 1
	},
/obj/structure/cable/yellow,
/mob/living/simple_animal/hostile/carp/cayenne,
/turf/open/floor/plating,
/area/shuttle/pod_shuttle)
"v" = (
/obj/machinery/computer/camera_advanced/syndie,
/turf/open/floor/mineral/plastitanium/red,
/area/shuttle/pod_shuttle)
"y" = (
/obj/structure/cable/yellow{
	icon_state = "2-8"
	},
/turf/open/floor/mineral/plastitanium,
/area/shuttle/pod_shuttle)
"A" = (
/obj/effect/turf_decal/stripes/line{
	dir = 1
	},
/obj/machinery/atmospherics/pipe/manifold/purple/visible{
	dir = 1
	},
/obj/structure/cable/yellow,
/turf/open/floor/plating,
/area/shuttle/pod_shuttle)
"B" = (
/obj/effect/turf_decal/bot,
/turf/open/floor/mineral/plastitanium,
/area/shuttle/pod_shuttle)
"C" = (
/turf/closed/wall/mineral/plastitanium/nodiagonal,
/area/shuttle/pod_shuttle)
"D" = (
/obj/structure/cable/yellow{
	icon_state = "2-4"
	},
/turf/open/floor/mineral/plastitanium,
/area/shuttle/pod_shuttle)
"E" = (
/obj/machinery/atmospherics/components/unary/shuttle/heater{
	dir = 1
	},
/obj/effect/spawner/structure/window/plastitanium,
/turf/open/floor/plating,
/area/shuttle/pod_shuttle)
"F" = (
/obj/effect/turf_decal/stripes/corner{
	dir = 4
	},
/obj/structure/table/reinforced,
/obj/item/toy/nuke,
/obj/item/toy/cards/deck/syndicate,
/turf/open/floor/mineral/plastitanium,
/area/shuttle/pod_shuttle)
"H" = (
/obj/machinery/shuttle/engine/plasma{
	dir = 1
	},
/turf/open/floor/plating,
/area/shuttle/pod_shuttle)
"J" = (
/obj/effect/turf_decal/stripes/corner{
	dir = 1
	},
/obj/structure/table/reinforced,
/obj/item/storage/toolbox/syndicate,
/turf/open/floor/mineral/plastitanium,
/area/shuttle/pod_shuttle)
"L" = (
/obj/structure/cable/yellow{
	icon_state = "1-2"
	},
/obj/structure/cable/yellow{
	icon_state = "1-8"
	},
/obj/structure/cable/yellow{
	icon_state = "1-4"
	},
/turf/open/floor/mineral/plastitanium,
/area/shuttle/pod_shuttle)
"O" = (
/obj/machinery/computer/shuttle_flight{
	desc = "Occasionally used to call in a resupply shuttle if one is in range.";
	icon_keyboard = "syndie_key";
	icon_screen = "syndishuttle";
	light_color = "#FA8282";
	name = "syndicate cargo shuttle console";
	possible_destinations = "syndielavaland_cargo";
	req_access_txt = "150";
	shuttleId = "syndie_cargo"
	},
/turf/open/floor/mineral/plastitanium/red,
/area/shuttle/pod_shuttle)
"Q" = (
/obj/effect/turf_decal/stripes/line{
	dir = 1
	},
/obj/machinery/light/small{
	dir = 8
	},
/obj/machinery/atmospherics/components/unary/plasma_refiner{
	dir = 4
	},
/turf/open/floor/plating,
/area/shuttle/pod_shuttle)
"R" = (
/obj/effect/turf_decal/stripes/line{
	dir = 1
	},
/obj/machinery/atmospherics/pipe/manifold/purple/visible{
	dir = 1
	},
/obj/machinery/power/port_gen/pacman,
/obj/structure/cable/yellow,
/turf/open/floor/plating,
/area/shuttle/pod_shuttle)
"S" = (
/obj/structure/cable/yellow{
	icon_state = "4-8"
	},
/turf/open/floor/mineral/plastitanium,
/area/shuttle/pod_shuttle)
"T" = (
/turf/closed/wall/mineral/plastitanium,
/area/shuttle/pod_shuttle)
"U" = (
/obj/effect/turf_decal/bot,
/obj/machinery/modular_fabricator/autolathe/hacked,
/turf/open/floor/mineral/plastitanium,
/area/shuttle/pod_shuttle)
"V" = (
/obj/structure/fans/tiny,
/obj/effect/turf_decal/stripes/line{
	dir = 4
	},
/obj/effect/turf_decal/stripes/line{
	dir = 8
	},
/obj/machinery/door/airlock/centcom{
	name = "Shuttle Airlock"
	},
/turf/open/floor/mineral/plastitanium/red,
/area/shuttle/pod_shuttle)
"W" = (
/obj/machinery/computer/crew/syndie,
/turf/open/floor/mineral/plastitanium/red,
/area/shuttle/pod_shuttle)
"X" = (
/obj/structure/chair/fancy/shuttle{
	dir = 4
	},
/obj/effect/turf_decal/stripes/line{
	dir = 6
	},
/obj/machinery/power/apc/auto_name/directional/west{
	pixel_x = -24
	},
/obj/structure/cable/yellow{
	icon_state = "0-4"
	},
/turf/open/floor/mineral/plastitanium/red,
/area/shuttle/pod_shuttle)
"Y" = (
/obj/effect/turf_decal/bot,
/obj/structure/closet/crate,
/obj/effect/spawner/lootdrop/maintenance/two,
/obj/item/clothing/glasses/sunglasses/advanced,
/obj/structure/cable/yellow{
	icon_state = "2-8"
	},
/turf/open/floor/mineral/plastitanium,
/area/shuttle/pod_shuttle)
"Z" = (
/obj/effect/turf_decal/stripes/line{
	dir = 1
	},
/obj/machinery/portable_atmospherics/canister/plasma,
/obj/machinery/atmospherics/components/unary/portables_connector/visible{
	dir = 8
	},
/obj/machinery/light/small{
	dir = 4
	},
/turf/open/floor/plating,
/area/shuttle/pod_shuttle)

(1,1,1) = {"
n
T
q
T
T
q
V
T
T
T
n
"}
(2,1,1) = {"
q
q
F
l
X
U
B
B
Q
C
C
"}
(3,1,1) = {"
q
v
f
a
S
a
a
D
u
E
H
"}
(4,1,1) = {"
q
O
c
a
Y
p
s
L
R
E
H
"}
(5,1,1) = {"
q
W
f
a
a
a
a
y
A
E
H
"}
(6,1,1) = {"
q
q
J
i
o
B
B
B
Z
C
C
"}
(7,1,1) = {"
n
T
q
T
T
q
g
T
T
T
n
"}
