//MAP CONVERTED BY dmm2tgm.py THIS HEADER COMMENT PREVENTS RECONVERSION, DO NOT REMOVE
"aa" = (
/obj/machinery/light{
	dir = 1
	},
/obj/effect/decal/cleanable/dirt,
/obj/effect/decal/cleanable/dirt,
/obj/effect/turf_decal/stripes/line{
	dir = 1
	},
/obj/machinery/status_display/supply{
	pixel_y = 32
	},
/turf/open/floor/plasteel/tech,
/area/shuttle/supply)
"cu" = (
/obj/effect/decal/cleanable/dirt,
/obj/machinery/conveyor{
	dir = 8;
	id = "QMLoad1"
	},
/turf/open/floor/plasteel/tech,
/area/shuttle/supply)
"cM" = (
/obj/machinery/conveyor/inverted{
	dir = 9;
	id = "QMLoad1"
	},
/turf/open/floor/plasteel/tech,
/area/shuttle/supply)
"dB" = (
/turf/closed/wall/mineral/titanium/survival/nodiagonal,
/area/shuttle/supply)
"eV" = (
/obj/effect/decal/cleanable/dirt,
/obj/effect/decal/cleanable/dirt,
/obj/machinery/conveyor{
	dir = 8;
	id = "QMLoad1"
	},
/turf/open/floor/plasteel/tech,
/area/shuttle/supply)
"gn" = (
/turf/template_noop,
/area/template_noop)
"he" = (
/obj/effect/turf_decal/bot,
/obj/effect/decal/cleanable/oil/streak,
/turf/open/floor/plasteel/tech/grid,
/area/shuttle/supply)
"lj" = (
/obj/effect/turf_decal/bot,
/obj/machinery/holopad,
/turf/open/floor/plasteel/tech/grid,
/area/shuttle/supply)
"op" = (
/obj/effect/turf_decal/stripes/line{
	dir = 10
	},
/obj/effect/turf_decal/loading_area{
	dir = 1
	},
/turf/open/floor/plasteel/tech/grid,
/area/shuttle/supply)
"rH" = (
/obj/effect/turf_decal/bot,
/obj/effect/decal/cleanable/dirt,
/turf/open/floor/plasteel/tech/grid,
/area/shuttle/supply)
"rQ" = (
/obj/structure/shuttle/engine/heater{
	dir = 4
	},
/obj/effect/spawner/structure/window/hollow/survival_pod/directional{
	dir = 4
	},
/turf/open/floor/plating,
/area/shuttle/supply)
"sH" = (
/obj/effect/turf_decal/bot,
/obj/effect/decal/cleanable/dirt,
/obj/effect/decal/cleanable/dirt,
/obj/effect/turf_decal/stripes/line{
	dir = 9
	},
/turf/open/floor/plasteel/tech/grid,
/area/shuttle/supply)
"sM" = (
/obj/effect/spawner/structure/window/hollow/survival_pod/directional,
/turf/open/floor/plating,
/area/shuttle/supply)
"td" = (
/obj/structure/shuttle/engine/propulsion/burst/right{
	dir = 4
	},
/turf/open/floor/plating/airless,
/area/shuttle/supply)
"xW" = (
/obj/effect/turf_decal/stripes/closeup{
	dir = 4
	},
/obj/structure/table/reinforced,
/turf/open/floor/plasteel/sepia,
/area/shuttle/supply)
"yg" = (
/obj/effect/turf_decal/bot,
/obj/effect/decal/cleanable/dirt,
/obj/effect/turf_decal/stripes/line{
	dir = 8
	},
/turf/open/floor/plasteel/tech/grid,
/area/shuttle/supply)
"yk" = (
/turf/closed/wall/mineral/titanium/survival,
/area/shuttle/supply)
"yl" = (
/obj/effect/decal/cleanable/dirt,
/obj/effect/turf_decal/stripes/line{
	dir = 5
	},
/obj/machinery/conveyor{
	id = "QMLoad1"
	},
/turf/open/floor/plasteel/tech,
/area/shuttle/supply)
"yY" = (
/obj/effect/turf_decal/bot,
/turf/open/floor/plasteel/tech/grid,
/area/shuttle/supply)
"zL" = (
/obj/effect/turf_decal/stripes/line{
	dir = 5
	},
/obj/machinery/conveyor_switch/oneway{
	id = "QMLoad2";
	name = "Unloading ramp Switch"
	},
/obj/machinery/button/door{
	id = "QMLoaddoor";
	layer = 4;
	name = "Loading Doors";
	pixel_y = 25;
	req_access_txt = "31"
	},
/turf/open/floor/plasteel/tech,
/area/shuttle/supply)
"zO" = (
/obj/effect/turf_decal/bot,
/obj/effect/decal/cleanable/oil/streak,
/obj/effect/turf_decal/stripes/corner{
	dir = 1
	},
/turf/open/floor/plasteel/tech/grid,
/area/shuttle/supply)
"zU" = (
/obj/effect/spawner/structure/window/hollow/survival_pod/directional{
	dir = 1
	},
/turf/open/floor/plating,
/area/shuttle/supply)
"Be" = (
/obj/machinery/door/poddoor{
	id = "QMLoaddoor";
	name = "Supply Dock Loading Door"
	},
/obj/machinery/conveyor{
	id = "QMLoad1"
	},
/obj/structure/plasticflaps,
/obj/machinery/conveyor{
	id = "QMLoad1"
	},
/turf/open/floor/plasteel/tech,
/area/shuttle/supply)
"CR" = (
/obj/effect/turf_decal/bot,
/obj/effect/decal/cleanable/oil/streak,
/obj/effect/turf_decal/stripes/corner{
	dir = 4
	},
/turf/open/floor/plasteel/tech/grid,
/area/shuttle/supply)
"DT" = (
/obj/structure/chair/office/light{
	dir = 8;
	pixel_y = 3
	},
/turf/open/floor/plasteel/tech,
/area/shuttle/supply)
"EO" = (
/turf/open/floor/plasteel/tech,
/area/shuttle/supply)
"GE" = (
/obj/effect/spawner/structure/window/hollow/survival_pod/directional{
	dir = 4
	},
/obj/structure/shuttle/engine/heater{
	dir = 4
	},
/turf/open/floor/plating,
/area/shuttle/supply)
"GU" = (
/obj/machinery/light{
	dir = 4
	},
/obj/effect/decal/cleanable/dirt,
/obj/machinery/conveyor{
	dir = 10;
	id = "QMLoad1"
	},
/turf/open/floor/plasteel/tech,
/area/shuttle/supply)
"Ha" = (
/obj/effect/turf_decal/stripes/line,
/obj/effect/turf_decal/loading_area{
	dir = 1
	},
/obj/effect/decal/cleanable/glass{
	dir = 4
	},
/turf/open/floor/plasteel/tech/grid,
/area/shuttle/supply)
"HJ" = (
/obj/effect/decal/cleanable/dirt,
/obj/effect/turf_decal/stripes/line{
	dir = 4
	},
/obj/machinery/conveyor{
	id = "QMLoad1"
	},
/turf/open/floor/plasteel/tech,
/area/shuttle/supply)
"Ij" = (
/obj/effect/decal/cleanable/dirt,
/obj/structure/chair/office/light{
	dir = 8;
	pixel_y = 3
	},
/turf/open/floor/plasteel/tech,
/area/shuttle/supply)
"Iv" = (
/obj/effect/turf_decal/stripes/line,
/obj/effect/turf_decal/loading_area{
	dir = 1
	},
/turf/open/floor/plasteel/tech/grid,
/area/shuttle/supply)
"Ix" = (
/obj/machinery/door/airlock/survival_pod/glass{
	dir = 4
	},
/turf/open/floor/plating,
/area/shuttle/supply)
"Jn" = (
/obj/machinery/door/poddoor{
	id = "QMLoaddoor2";
	name = "Supply Dock Loading Door"
	},
/obj/structure/plasticflaps,
/obj/machinery/conveyor{
	dir = 1;
	id = "QMLoad2"
	},
/turf/open/floor/plasteel/tech,
/area/shuttle/supply)
"Jv" = (
/obj/structure/shuttle/engine/propulsion{
	dir = 4
	},
/turf/open/floor/plating/airless,
/area/shuttle/supply)
"JY" = (
/obj/effect/decal/cleanable/dirt,
/obj/effect/decal/cleanable/dirt,
/obj/effect/turf_decal/stripes/line{
	dir = 6
	},
/obj/machinery/conveyor{
	id = "QMLoad1"
	},
/turf/open/floor/plasteel/tech,
/area/shuttle/supply)
"Kh" = (
/obj/machinery/light{
	dir = 8
	},
/obj/effect/decal/cleanable/dirt,
/obj/machinery/conveyor{
	dir = 4;
	id = "QMLoad2"
	},
/turf/open/floor/plasteel/tech,
/area/shuttle/supply)
"Lw" = (
/obj/structure/sign/warning/fire,
/turf/closed/wall/mineral/titanium/survival/nodiagonal,
/area/shuttle/supply)
"MU" = (
/obj/effect/turf_decal/bot,
/obj/effect/decal/cleanable/glass{
	dir = 4
	},
/turf/open/floor/plasteel/tech/grid,
/area/shuttle/supply)
"Nx" = (
/obj/effect/decal/cleanable/dirt,
/obj/effect/turf_decal/stripes/line{
	dir = 1
	},
/obj/effect/turf_decal/bot,
/turf/open/floor/plasteel/tech/grid,
/area/shuttle/supply)
"NX" = (
/obj/machinery/door/airlock/survival_pod/glass{
	dir = 4
	},
/obj/docking_port/mobile/supply{
	dir = 2
	},
/turf/open/floor/plating,
/area/shuttle/supply)
"Og" = (
/obj/effect/turf_decal/stripes/end{
	dir = 1
	},
/obj/machinery/computer/cargo{
	dir = 4
	},
/turf/open/floor/plasteel/sepia,
/area/shuttle/supply)
"Oo" = (
/obj/structure/shuttle/engine/propulsion/burst/left{
	dir = 4
	},
/turf/open/floor/plating/airless,
/area/shuttle/supply)
"OE" = (
/obj/machinery/light{
	dir = 8
	},
/obj/effect/decal/cleanable/dirt,
/obj/effect/decal/cleanable/dirt,
/obj/effect/turf_decal/delivery,
/turf/open/floor/plasteel/tech,
/area/shuttle/supply)
"OU" = (
/obj/effect/decal/cleanable/dirt,
/obj/effect/turf_decal/stripes/line,
/obj/effect/turf_decal/loading_area{
	dir = 1
	},
/turf/open/floor/plasteel/tech/grid,
/area/shuttle/supply)
"Pe" = (
/obj/effect/decal/cleanable/dirt,
/obj/effect/decal/cleanable/dirt,
/obj/effect/turf_decal/caution/stand_clear,
/turf/open/floor/plasteel/tech,
/area/shuttle/supply)
"PL" = (
/obj/machinery/light,
/obj/machinery/status_display/supply{
	pixel_y = -32
	},
/obj/machinery/conveyor{
	dir = 8;
	id = "QMLoad1"
	},
/turf/open/floor/plasteel/tech,
/area/shuttle/supply)
"Qp" = (
/turf/closed/wall/mineral/plastitanium,
/area/shuttle/supply)
"Qw" = (
/obj/machinery/light{
	dir = 4
	},
/obj/machinery/conveyor{
	dir = 6;
	id = "QMLoad1"
	},
/turf/open/floor/plasteel/tech,
/area/shuttle/supply)
"WN" = (
/obj/effect/turf_decal/stripes/line{
	dir = 9
	},
/obj/machinery/conveyor_switch/oneway{
	dir = 8;
	id = "MailConv"
	},
/obj/machinery/button/door{
	id = "QMLoaddoor2";
	layer = 4;
	name = "Loading Doors";
	pixel_y = 25;
	req_access_txt = "31"
	},
/turf/open/floor/plasteel/tech,
/area/shuttle/supply)
"Xh" = (
/obj/machinery/conveyor/inverted{
	dir = 10;
	id = "QMLoad2"
	},
/turf/open/floor/plasteel/tech,
/area/shuttle/supply)
"Xs" = (
/obj/effect/turf_decal/stripes/end,
/obj/machinery/computer/shuttle_flight{
	dir = 4
	},
/turf/open/floor/plasteel/sepia,
/area/shuttle/supply)
"Xy" = (
/obj/effect/spawner/structure/window/hollow/survival_pod/directional{
	dir = 8
	},
/turf/open/floor/plating,
/area/shuttle/supply)
"ZV" = (
/obj/machinery/conveyor{
	dir = 8;
	id = "QMLoad1"
	},
/turf/open/floor/plasteel/tech,
/area/shuttle/supply)

(1,1,1) = {"
gn
yk
Xy
Xy
Xy
yk
gn
"}
(2,1,1) = {"
yk
yk
Og
xW
Xs
yk
yk
"}
(3,1,1) = {"
zU
Kh
Ij
EO
DT
OE
sM
"}
(4,1,1) = {"
Jn
Xh
sH
yg
op
cu
sM
"}
(5,1,1) = {"
yk
WN
zO
rH
Iv
cu
sM
"}
(6,1,1) = {"
Ix
Pe
he
rH
Iv
ZV
sM
"}
(7,1,1) = {"
yk
aa
MU
lj
OU
PL
yk
"}
(8,1,1) = {"
NX
Pe
rH
yY
Ha
ZV
sM
"}
(9,1,1) = {"
yk
zL
CR
rH
Iv
cu
sM
"}
(10,1,1) = {"
Be
cM
Nx
rH
OU
eV
sM
"}
(11,1,1) = {"
zU
Qw
yl
HJ
JY
GU
sM
"}
(12,1,1) = {"
dB
Lw
rQ
rQ
GE
Lw
dB
"}
(13,1,1) = {"
Qp
td
Jv
Jv
Jv
Oo
Qp
"}
