//MAP CONVERTED BY dmm2tgm.py THIS HEADER COMMENT PREVENTS RECONVERSION, DO NOT REMOVE
"a" = (
/turf/open/floor/holofloor{
	icon_state = "white"
	},
/area/template_noop)
"f" = (
/obj/item/cardboard_cutout/adaptive/chess/pawn,
/turf/open/floor/holofloor/dark,
/area/template_noop)
"g" = (
/obj/item/cardboard_cutout/adaptive/chess/black/pawn,
/turf/open/floor/holofloor/dark,
/area/template_noop)
"i" = (
/obj/item/cardboard_cutout/adaptive/chess/black/pawn,
/turf/open/floor/holofloor{
	icon_state = "white"
	},
/area/template_noop)
"m" = (
/obj/item/cardboard_cutout/adaptive/chess/rook,
/turf/open/floor/holofloor/dark,
/area/template_noop)
"o" = (
/obj/item/cardboard_cutout/adaptive/chess/black/king,
/turf/open/floor/holofloor{
	icon_state = "white"
	},
/area/template_noop)
"p" = (
/obj/item/cardboard_cutout/adaptive/chess/black/rook,
/turf/open/floor/holofloor/dark,
/area/template_noop)
"t" = (
/obj/item/cardboard_cutout/adaptive/chess/bishop,
/turf/open/floor/holofloor/dark,
/area/template_noop)
"v" = (
/obj/item/cardboard_cutout/adaptive/chess/knight,
/turf/open/floor/holofloor{
	icon_state = "white"
	},
/area/template_noop)
"y" = (
/obj/item/cardboard_cutout/adaptive/chess/black/bishop,
/turf/open/floor/holofloor/dark,
/area/template_noop)
"B" = (
/obj/item/cardboard_cutout/adaptive/chess/pawn,
/turf/open/floor/holofloor{
	icon_state = "white"
	},
/area/template_noop)
"J" = (
/obj/item/cardboard_cutout/adaptive/chess/king,
/turf/open/floor/holofloor{
	icon_state = "white"
	},
/area/template_noop)
"P" = (
/obj/item/cardboard_cutout/adaptive/chess/black/knight,
/turf/open/floor/holofloor{
	icon_state = "white"
	},
/area/template_noop)
"S" = (
/turf/open/floor/holofloor/dark,
/area/template_noop)

(1,1,1) = {"
J
f
a
S
a
S
i
p
"}
(2,1,1) = {"
t
B
S
a
S
a
g
P
"}
(3,1,1) = {"
v
f
a
S
a
S
i
y
"}
(4,1,1) = {"
m
B
S
a
S
a
g
o
"}
