//MAP CONVERTED BY dmm2tgm.py THIS HEADER COMMENT PREVENTS RECONVERSION, DO NOT REMOVE
"aa" = (
/obj/structure/musician/piano,
/turf/open/floor/iron/dark,
/area/template_noop)
"ab" = (
/obj/machinery/light/small{
	dir = 1
	},
/obj/structure/chair/stool/directional/west,
/turf/open/floor/iron/dark,
/area/template_noop)
"ac" = (
/turf/closed/wall,
/area/template_noop)
"ad" = (
/turf/open/floor/plating,
/area/template_noop)
"ae" = (
/turf/open/floor/iron/stairs/left,
/area/template_noop)
"af" = (
/turf/open/floor/iron/stairs/right,
/area/template_noop)
"ag" = (
/obj/effect/spawner/lootdrop/three_course_meal,
/obj/effect/spawner/lootdrop/three_course_meal,
/obj/structure/closet/crate,
/obj/item/paper/crumpled/beernuke,
/turf/open/floor/plating{
	broken = 1
	},
/area/template_noop)
"ah" = (
/obj/structure/sign/barsign,
/turf/closed/wall,
/area/template_noop)
"ai" = (
/obj/structure/extinguisher_cabinet{
	pixel_x = 24
	},
/turf/open/floor/plating{
	broken = 1
	},
/area/template_noop)
"aj" = (
/turf/open/floor/wood,
/area/template_noop)
"ak" = (
/obj/machinery/vending/boozeomat/maint,
/turf/closed/wall,
/area/template_noop)
"al" = (
/obj/structure/table,
/turf/open/floor/plating,
/area/template_noop)
"am" = (
/obj/structure/table,
/obj/item/reagent_containers/food/drinks/bottle/vodka/badminka{
	pixel_x = 6;
	pixel_y = 10
	},
/obj/item/reagent_containers/food/drinks/bottle/tequila{
	pixel_x = -6;
	pixel_y = 4
	},
/obj/item/reagent_containers/food/drinks/shaker,
/turf/open/floor/plating,
/area/template_noop)
"an" = (
/obj/structure/table,
/obj/machinery/chem_dispenser/drinks/beer,
/obj/structure/sign/poster/contraband/random{
	pixel_x = 32
	},
/turf/open/floor/plating,
/area/template_noop)
"ao" = (
/turf/open/floor/carpet,
/area/template_noop)
"ap" = (
/obj/item/chair/stool,
/turf/open/floor/carpet,
/area/template_noop)
"aq" = (
/obj/structure/sign/poster/contraband/random{
	pixel_y = 32
	},
/turf/open/floor/carpet,
/area/template_noop)
"ar" = (
/turf/open/floor/plating{
	broken = 1
	},
/area/template_noop)
"as" = (
/obj/effect/decal/cleanable/oil{
	icon_state = "floor5"
	},
/turf/open/floor/plating,
/area/template_noop)
"at" = (
/obj/item/cigbutt/cigarbutt,
/turf/open/floor/plating{
	burnt = 1
	},
/area/template_noop)
"au" = (
/obj/structure/mineral_door/wood,
/turf/open/floor/plating,
/area/template_noop)
"av" = (
/obj/structure/sign/poster/contraband/random{
	pixel_x = -32
	},
/obj/structure/chair/fancy/comfy{
	color = "#666666";
	dir = 4
	},
/turf/open/floor/carpet,
/area/template_noop)
"aw" = (
/obj/structure/table/wood/poker,
/obj/item/toy/cards/deck,
/turf/open/floor/carpet,
/area/template_noop)
"ax" = (
/obj/structure/chair/fancy/comfy{
	color = "#666666";
	dir = 8
	},
/turf/open/floor/carpet,
/area/template_noop)
"ay" = (
/obj/structure/table,
/obj/item/reagent_containers/food/drinks/drinkingglass/shotglass{
	pixel_x = 4;
	pixel_y = 7
	},
/obj/item/reagent_containers/food/drinks/drinkingglass/shotglass,
/turf/open/floor/plating,
/area/template_noop)
"az" = (
/obj/structure/table,
/obj/item/storage/fancy/cigarettes/cigars,
/obj/item/stack/spacecash/c20,
/turf/open/floor/plating,
/area/template_noop)
"aA" = (
/obj/structure/table,
/obj/item/reagent_containers/food/drinks/bottle/gin{
	pixel_y = 8
	},
/obj/machinery/light/small{
	dir = 4
	},
/turf/open/floor/plating,
/area/template_noop)
"aB" = (
/obj/structure/chair/stool/directional/north,
/turf/open/floor/carpet,
/area/template_noop)
"aC" = (
/obj/item/cigbutt/roach,
/turf/open/floor/carpet,
/area/template_noop)
"aD" = (
/obj/item/clothing/suit/apron/chef,
/turf/open/floor/plating,
/area/template_noop)
"aE" = (
/obj/structure/sign/poster/contraband/random{
	pixel_x = -32
	},
/obj/effect/spawner/lootdrop/maintenance,
/turf/open/floor/wood{
	broken = 1
	},
/area/template_noop)
"aF" = (
/turf/open/floor/wood{
	broken = 1
	},
/area/template_noop)
"aG" = (
/obj/effect/spawner/lootdrop/maintenance,
/turf/open/floor/wood,
/area/template_noop)
"aH" = (
/turf/open/floor/iron/stairs/medium,
/area/template_noop)
"aI" = (
/obj/structure/sign/poster/contraband/random{
	pixel_x = 32
	},
/turf/open/floor/iron/stairs/right,
/area/template_noop)
"aJ" = (
/obj/machinery/door/airlock/maintenance{
	name = "Pete's Speakeasy"
	},
/turf/open/floor/plating,
/area/template_noop)
"aK" = (
/obj/item/reagent_containers/cup/bucket,
/obj/item/mop,
/obj/structure/sink{
	dir = 4;
	pixel_x = 11
	},
/obj/effect/decal/cleanable/dirt,
/turf/open/floor/plating,
/area/template_noop)
"aL" = (
/obj/item/coin/silver,
/obj/effect/decal/cleanable/oil{
	icon_state = "floor5"
	},
/obj/structure/light_construct/small{
	dir = 8
	},
/turf/open/floor/iron/dark,
/area/template_noop)
"aM" = (
/obj/item/clothing/under/rank/civilian/clown/sexy,
/obj/effect/spawner/lootdrop/clowntrap,
/obj/effect/spawner/lootdrop/trap,
/turf/open/floor/iron/dark,
/area/template_noop)
"aN" = (
/obj/structure/chair{
	dir = 8
	},
/obj/item/stack/spacecash/c10,
/turf/open/floor/iron/dark,
/area/template_noop)
"aO" = (
/obj/structure/closet/firecloset,
/obj/effect/decal/cleanable/cobweb,
/obj/machinery/light/small{
	brightness = 3;
	dir = 8
	},
/turf/open/floor/plating{
	broken = 1
	},
/area/template_noop)
"aP" = (
/obj/structure/table,
/obj/item/restraints/legcuffs/beartrap,
/obj/item/restraints/legcuffs/beartrap,
/obj/item/reagent_containers/spray/cleaner,
/obj/effect/decal/cleanable/dirt,
/turf/open/floor/plating,
/area/template_noop)
"aQ" = (
/obj/structure/festivus{
	anchored = 1;
	name = "pole"
	},
/turf/open/floor/iron/dark,
/area/template_noop)
"aR" = (
/turf/open/floor/iron/dark,
/area/template_noop)
"aS" = (
/obj/structure/chair{
	dir = 8
	},
/obj/structure/sign/poster/contraband/random{
	pixel_x = 32
	},
/obj/effect/decal/cleanable/oil{
	icon_state = "floor6"
	},
/turf/open/floor/iron/dark,
/area/template_noop)
"aT" = (
/obj/structure/chair{
	dir = 4
	},
/obj/item/clothing/mask/cigarette,
/turf/open/floor/plating,
/area/template_noop)
"aU" = (
/obj/structure/reagent_dispensers/watertank,
/turf/open/floor/plating,
/area/template_noop)
"aV" = (
/obj/item/reagent_containers/glass/bucket,
/obj/item/mop,
/obj/structure/sink{
	dir = 4;
	pixel_x = 11
	},
/obj/effect/decal/cleanable/dirt,
/turf/open/floor/plating,
/area/template_noop)
"aW" = (
/obj/structure/table,
/obj/item/reagent_containers/cup/glass/drinkingglass/shotglass{
	pixel_x = 4;
	pixel_y = 7
	},
/obj/item/reagent_containers/cup/glass/drinkingglass/shotglass,
/turf/open/floor/plating,
/area/template_noop)
"aX" = (
/obj/structure/chair/stool/directional/south,
/turf/open/floor/carpet,
/area/template_noop)
"aY" = (
/obj/structure/table,
/obj/item/clothing/under/costume/maid,
/obj/item/grenade/chem_grenade/cleaner,
/obj/effect/turf_decal/tile/neutral/half/contrasted,
/turf/open/floor/plating,
/area/template_noop)
"aZ" = (
/obj/structure/table,
/obj/item/reagent_containers/cup/glass/bottle/gin{
	pixel_y = 8
	},
/obj/machinery/light/small{
	dir = 4
	},
/turf/open/floor/plating,
/area/template_noop)
"Oo" = (
/obj/structure/table,
/obj/item/reagent_containers/cup/glass/bottle/vodka/badminka{
	pixel_x = 6;
	pixel_y = 10
	},
/obj/item/reagent_containers/cup/glass/bottle/tequila{
	pixel_x = -6;
	pixel_y = 4
	},
/obj/item/reagent_containers/cup/glass/shaker,
/turf/open/floor/plating,
/area/template_noop)

(1,1,1) = {"
aa
ae
aj
ao
av
ao
aE
ae
aL
aQ
"}
(2,1,1) = {"
ab
af
aj
ap
aw
aX
aj
aH
aM
aR
"}
(3,1,1) = {"
ac
ac
ac
aq
ax
aC
aF
aI
aN
aS
"}
(4,1,1) = {"
ad
ag
ac
ac
ac
aj
aj
ac
ac
ac
"}
(5,1,1) = {"
ad
ac
ak
ar
al
aj
aF
ac
aO
aT
"}
(6,1,1) = {"
ad
ah
al
ar
aW
aj
aj
aJ
ad
ad
"}
(7,1,1) = {"
ad
ac
Oo
as
az
aj
aj
ac
ac
ac
"}
(8,1,1) = {"
ad
ac
an
at
aZ
aj
aG
au
ad
aU
"}
(9,1,1) = {"
ad
ac
ac
au
ac
au
ac
ac
ad
ad
"}
(10,1,1) = {"
ad
ai
ad
ad
ad
aD
ac
aY
aP
aK
"}
