//MAP CONVERTED BY dmm2tgm.py THIS HEADER COMMENT PREVENTS RECONVERSION, DO NOT REMOVE
"a" = (
/turf/closed/wall,
/area/ruin/unpowered)
"b" = (
/obj/structure/closet/secure_closet/personal/cabinet,
/obj/effect/turf_decal/siding/wood{
	dir = 1
	},
/turf/open/floor/wood,
/area/ruin/unpowered)
"c" = (
/obj/effect/turf_decal/tile/neutral/fourcorners/contrasted,
/obj/effect/turf_decal/stripes/corner,
/turf/open/floor/iron/dark,
/area/ruin/unpowered)
"d" = (
/obj/effect/turf_decal/tile/neutral/fourcorners/contrasted,
/obj/effect/turf_decal/stripes/corner{
	dir = 4
	},
/turf/open/floor/iron/dark,
/area/ruin/unpowered)
"e" = (
/obj/machinery/camera/autoname{
	dir = 9
	},
/obj/effect/turf_decal/tile/neutral/fourcorners/contrasted,
/turf/open/floor/iron/dark,
/area/ruin/unpowered)
"f" = (
/turf/open/floor/wood,
/area/ruin/unpowered)
"i" = (
/obj/effect/turf_decal/siding/wood/corner{
	dir = 4
	},
/obj/effect/turf_decal/siding/wood,
/turf/open/floor/wood,
/area/ruin/unpowered)
"j" = (
/obj/machinery/button/door{
	id = "Dorm2";
	name = "Dormitory Door Lock";
	normaldoorcontrol = 1;
	pixel_x = 28;
	pixel_y = -5;
	specialfunctions = 4
	},
/obj/effect/turf_decal/siding/wood{
	dir = 4
	},
/turf/open/floor/wood,
/area/ruin/unpowered)
"k" = (
/obj/machinery/light{
	dir = 8
	},
/obj/effect/turf_decal/tile/neutral/fourcorners/contrasted,
/turf/open/floor/iron/dark,
/area/ruin/unpowered)
"l" = (
/obj/machinery/door/airlock{
	id_tag = "Dorm2";
	name = "Cabin 2"
	},
/obj/machinery/door/firedoor,
/obj/effect/turf_decal/siding/wood/end{
	dir = 4
	},
/turf/open/floor/wood,
/area/ruin/unpowered)
"m" = (
/obj/structure/bed,
/obj/item/bedsheet/dorms,
/obj/effect/turf_decal/siding/wood{
	dir = 5
	},
/turf/open/floor/wood,
/area/ruin/unpowered)
"n" = (
/obj/structure/table/wood,
/obj/item/folder/red,
/obj/item/pen,
/obj/machinery/button/door{
	desc = "A remote control switch.";
	id = "dorm2";
	name = "Privacy Shutters";
	pixel_x = -4;
	pixel_y = -26
	},
/obj/effect/turf_decal/siding/wood{
	dir = 10
	},
/turf/open/floor/wood,
/area/ruin/unpowered)
"o" = (
/obj/item/kirbyplants/random,
/obj/machinery/newscaster{
	pixel_y = -30
	},
/obj/effect/turf_decal/siding/wood,
/turf/open/floor/wood,
/area/ruin/unpowered)
"p" = (
/obj/effect/spawner/structure/window/reinforced/tinted,
/obj/effect/turf_decal/tile/neutral/fourcorners/contrasted,
/turf/open/floor/plating,
/area/ruin/unpowered)
"q" = (
/obj/effect/turf_decal/siding/wood/corner,
/obj/effect/turf_decal/siding/wood{
	dir = 1
	},
/turf/open/floor/wood,
/area/ruin/unpowered)
"r" = (
/obj/machinery/door/airlock{
	name = "Recreational Area"
	},
/obj/effect/turf_decal/stripes/line,
/obj/effect/turf_decal/stripes/line{
	dir = 1
	},
/obj/structure/disposalpipe/segment,
/obj/machinery/door/firedoor,
/obj/effect/turf_decal/tile/neutral/fourcorners/contrasted,
/turf/open/floor/iron/dark,
/area/ruin/unpowered)
"s" = (
/obj/effect/turf_decal/tile/neutral/fourcorners/contrasted,
/obj/effect/abstract/open_area_marker{
	dir = 4
	},
/turf/open/floor/iron/dark,
/area/ruin/unpowered)
"u" = (
/obj/machinery/door/poddoor/shutters/preopen{
	id = "dorm1"
	},
/obj/effect/spawner/structure/window,
/turf/open/floor/plating,
/area/ruin/unpowered)
"w" = (
/obj/effect/turf_decal/stripes/line{
	dir = 4
	},
/obj/effect/turf_decal/tile/neutral/fourcorners/contrasted,
/turf/open/floor/noslip/dark,
/area/ruin/unpowered)
"y" = (
/obj/machinery/door/poddoor/shutters/preopen{
	id = "dorm2"
	},
/obj/effect/spawner/structure/window,
/turf/open/floor/plating,
/area/ruin/unpowered)
"z" = (
/obj/machinery/light/small{
	dir = 1
	},
/obj/effect/turf_decal/siding/wood{
	dir = 1
	},
/turf/open/floor/wood,
/area/ruin/unpowered)
"A" = (
/obj/structure/table/wood,
/obj/item/paper_bin{
	pixel_x = 4;
	pixel_y = 3
	},
/obj/item/razor{
	pixel_x = -9;
	pixel_y = 4
	},
/obj/item/radio/intercom{
	pixel_y = -28
	},
/obj/effect/turf_decal/siding/wood,
/turf/open/floor/wood,
/area/ruin/unpowered)
"B" = (
/obj/machinery/holopad,
/obj/effect/turf_decal/tile/neutral/fourcorners/contrasted,
/turf/open/floor/iron/dark,
/area/ruin/unpowered)
"C" = (
/obj/effect/turf_decal/tile/neutral/fourcorners/contrasted,
/obj/effect/abstract/open_area_marker,
/turf/open/floor/iron/dark,
/area/ruin/unpowered)
"E" = (
/obj/structure/chair/office,
/obj/effect/turf_decal/siding/wood{
	dir = 8
	},
/turf/open/floor/wood,
/area/ruin/unpowered)
"F" = (
/obj/machinery/door/airlock{
	id_tag = "Dorm1";
	name = "Cabin 1"
	},
/obj/machinery/door/firedoor,
/obj/effect/turf_decal/siding/wood/end{
	dir = 4
	},
/turf/open/floor/wood,
/area/ruin/unpowered)
"G" = (
/obj/item/kirbyplants/random,
/obj/machinery/newscaster{
	pixel_y = 32
	},
/obj/effect/turf_decal/siding/wood{
	dir = 1
	},
/turf/open/floor/wood,
/area/ruin/unpowered)
"J" = (
/obj/effect/turf_decal/tile/neutral/fourcorners/contrasted,
/obj/effect/abstract/open_area_marker{
	dir = 1
	},
/turf/open/floor/iron/dark,
/area/ruin/unpowered)
"M" = (
/obj/effect/turf_decal/tile/neutral/fourcorners/contrasted,
/turf/open/floor/iron/dark,
/area/ruin/unpowered)
"N" = (
/obj/machinery/light/small,
/obj/effect/turf_decal/siding/wood,
/turf/open/floor/wood,
/area/ruin/unpowered)
"O" = (
/obj/structure/bed,
/obj/item/bedsheet/dorms,
/obj/effect/turf_decal/siding/wood{
	dir = 6
	},
/turf/open/floor/wood,
/area/ruin/unpowered)
"Q" = (
/obj/structure/table/wood,
/obj/item/folder/red,
/obj/item/pen,
/obj/machinery/button/door{
	desc = "A remote control switch.";
	id = "dorm1";
	name = "Privacy Shutters";
	pixel_x = -4;
	pixel_y = -26
	},
/obj/effect/turf_decal/siding/wood{
	dir = 10
	},
/turf/open/floor/wood,
/area/ruin/unpowered)
"R" = (
/obj/machinery/door/airlock{
	name = "Recreational Area"
	},
/obj/effect/turf_decal/stripes/line,
/obj/effect/turf_decal/stripes/line{
	dir = 1
	},
/obj/machinery/door/firedoor,
/obj/effect/turf_decal/tile/neutral/fourcorners/contrasted,
/turf/open/floor/iron/dark,
/area/ruin/unpowered)
"T" = (
/obj/structure/dresser,
/obj/item/flashlight/lamp/green{
	pixel_x = -5;
	pixel_y = 14
	},
/obj/effect/turf_decal/siding/wood{
	dir = 9
	},
/turf/open/floor/wood,
/area/ruin/unpowered)
"U" = (
/obj/machinery/navbeacon{
	codes_txt = "patrol;next_patrol=hall23";
	location = "hall22"
	},
/obj/effect/turf_decal/tile/neutral/fourcorners/contrasted,
/turf/open/floor/iron/dark,
/area/ruin/unpowered)
"W" = (
/obj/effect/turf_decal/stripes/line{
	dir = 4
	},
/obj/effect/turf_decal/caution{
	dir = 8;
	pixel_x = -3
	},
/obj/effect/turf_decal/tile/neutral/fourcorners/contrasted,
/turf/open/floor/noslip/dark,
/area/ruin/unpowered)
"Z" = (
/obj/machinery/button/door{
	id = "Dorm1";
	name = "Dormitory Door Lock";
	normaldoorcontrol = 1;
	pixel_x = 28;
	pixel_y = 6;
	specialfunctions = 4
	},
/obj/effect/turf_decal/siding/wood{
	dir = 4
	},
/turf/open/floor/wood,
/area/ruin/unpowered)

(1,1,1) = {"
a
y
y
y
a
u
u
u
a
"}
(2,1,1) = {"
a
T
E
n
a
T
E
Q
a
"}
(3,1,1) = {"
a
b
f
A
a
b
f
A
a
"}
(4,1,1) = {"
a
G
f
N
a
z
f
o
a
"}
(5,1,1) = {"
a
m
j
i
a
q
Z
O
a
"}
(6,1,1) = {"
a
a
a
l
a
F
a
a
a
"}
(7,1,1) = {"
M
M
M
M
k
M
M
R
M
"}
(8,1,1) = {"
J
M
M
M
B
M
M
p
C
"}
(9,1,1) = {"
M
e
M
M
U
M
M
r
M
"}
(10,1,1) = {"
a
a
c
W
w
W
d
a
a
"}
(11,1,1) = {"
a
a
a
M
s
M
a
a
a
"}
