//MAP CONVERTED BY dmm2tgm.py THIS HEADER COMMENT PREVENTS RECONVERSION, DO NOT REMOVE
"bp" = (
/turf/template_noop,
/area/template_noop)
"cq" = (
/obj/structure/closet/secure_closet/personal/patient,
/obj/effect/turf_decal/bot{
	dir = 1
	},
/turf/open/floor/plasteel,
/area/ruin/unpowered)
"cO" = (
/obj/effect/turf_decal/guideline/guideline_edge/blue{
	dir = 4
	},
/turf/open/floor/plasteel/white,
/area/ruin/unpowered)
"dp" = (
/obj/effect/turf_decal/guideline/guideline_edge/blue,
/obj/item/radio/intercom{
	canhear_range = 6;
	dir = 1;
	pixel_x = 1;
	pixel_y = -29
	},
/turf/open/floor/plasteel/white/side{
	dir = 1
	},
/area/ruin/unpowered)
"du" = (
/obj/effect/turf_decal/guideline/guideline_tri/blue{
	color = "#52B4E9";
	dir = 8
	},
/turf/open/floor/plasteel/white/side{
	dir = 1
	},
/area/ruin/unpowered)
"ee" = (
/obj/effect/turf_decal/guideline/guideline_half_edge/blue{
	dir = 9
	},
/obj/effect/turf_decal/guideline/guideline_half_edge/blue{
	dir = 1
	},
/obj/effect/turf_decal/guideline/guideline_tri/blue{
	color = "#52B4E9";
	dir = 4
	},
/obj/effect/turf_decal/guideline/guideline_edge_alt/blue,
/turf/open/floor/plasteel/white/side{
	dir = 6
	},
/area/ruin/unpowered)
"ef" = (
/obj/structure/sign/poster/random,
/turf/closed/wall,
/area/ruin/unpowered)
"fh" = (
/obj/effect/decal/cleanable/blood/drip,
/obj/effect/turf_decal/guideline/guideline_edge/blue{
	dir = 4
	},
/turf/open/floor/plasteel/white,
/area/ruin/unpowered)
"fl" = (
/obj/effect/turf_decal/tile/blue/half{
	dir = 4
	},
/obj/machinery/door/firedoor,
/obj/effect/turf_decal/tile/blue/half{
	dir = 8
	},
/obj/effect/abstract/open_area_marker{
	dir = 4
	},
/turf/open/floor/plasteel/white,
/area/ruin/unpowered)
"fF" = (
/obj/machinery/light{
	dir = 1
	},
/obj/effect/turf_decal/bot{
	dir = 1
	},
/turf/open/floor/plasteel,
/area/ruin/unpowered)
"fT" = (
/obj/effect/decal/cleanable/blood/old,
/obj/effect/turf_decal/guideline/guideline_half_edge/blue,
/obj/effect/turf_decal/guideline/guideline_half_edge/blue{
	dir = 5
	},
/obj/effect/turf_decal/guideline/guideline_edge_alt/blue{
	dir = 1
	},
/turf/open/floor/plasteel/white/side{
	dir = 9
	},
/area/ruin/unpowered)
"gt" = (
/obj/effect/turf_decal/delivery,
/obj/machinery/light{
	dir = 4
	},
/obj/effect/decal/cleanable/blood/old,
/obj/structure/bed/roller,
/turf/open/floor/plasteel/grid/steel,
/area/ruin/unpowered)
"gu" = (
/obj/machinery/door/firedoor,
/obj/effect/turf_decal/tile/blue/fourcorners/contrasted,
/obj/effect/abstract/doorway_marker{
	dir = 1
	},
/turf/open/floor/plasteel/white,
/area/ruin/unpowered)
"gN" = (
/obj/effect/abstract/doorway_marker{
	dir = 8
	},
/turf/open/floor/plasteel/white,
/area/ruin/unpowered)
"hq" = (
/obj/machinery/firealarm{
	dir = 4;
	pixel_x = -33;
	pixel_y = 1
	},
/obj/effect/turf_decal/guideline/guideline_edge/blue{
	dir = 8
	},
/turf/open/floor/plasteel/white/side{
	dir = 8
	},
/area/ruin/unpowered)
"hU" = (
/obj/effect/decal/cleanable/blood/drip,
/turf/open/floor/plasteel,
/area/ruin/unpowered)
"iT" = (
/obj/effect/turf_decal/delivery,
/obj/machinery/stasis{
	dir = 4
	},
/turf/open/floor/plasteel/grid/steel,
/area/ruin/unpowered)
"iU" = (
/obj/effect/turf_decal/guideline/guideline_edge/blue{
	dir = 8
	},
/turf/open/floor/plasteel/white/side{
	dir = 6
	},
/area/ruin/unpowered)
"jy" = (
/obj/effect/decal/cleanable/blood/old,
/obj/effect/turf_decal/guideline/guideline_edge/blue{
	dir = 1
	},
/turf/open/floor/plasteel/white/side,
/area/ruin/unpowered)
"kV" = (
/obj/effect/turf_decal/guideline/guideline_edge_alt/blue{
	dir = 1
	},
/obj/effect/turf_decal/guideline/guideline_half_edge/blue,
/obj/effect/turf_decal/guideline/guideline_half_edge/blue{
	dir = 5
	},
/turf/open/floor/plasteel/white,
/area/ruin/unpowered)
"pp" = (
/obj/effect/turf_decal/delivery,
/mob/living/simple_animal/bot/cleanbot/medbay,
/turf/open/floor/plasteel/grid/steel,
/area/ruin/unpowered)
"pH" = (
/obj/machinery/airalarm/directional/east,
/obj/machinery/shower{
	dir = 8;
	name = "emergency shower";
	pixel_x = -1;
	pixel_y = -8
	},
/obj/effect/turf_decal/bot,
/obj/effect/turf_decal/guideline/guideline_edge/blue{
	dir = 4
	},
/turf/open/floor/noslip/white,
/area/ruin/unpowered)
"pP" = (
/obj/effect/turf_decal/bot{
	dir = 1
	},
/turf/open/floor/plasteel,
/area/ruin/unpowered)
"rp" = (
/obj/machinery/vending/medical,
/obj/effect/turf_decal/stripes/box,
/obj/structure/extinguisher_cabinet{
	pixel_x = 1;
	pixel_y = -33
	},
/obj/machinery/firealarm/directional/east,
/turf/open/floor/plasteel,
/area/ruin/unpowered)
"sa" = (
/obj/effect/decal/cleanable/blood/drip,
/obj/effect/turf_decal/guideline/guideline_edge/blue{
	dir = 4
	},
/turf/open/floor/plasteel/white/side{
	dir = 4
	},
/area/ruin/unpowered)
"se" = (
/obj/structure/flora/ausbushes/fullgrass,
/obj/structure/window/reinforced{
	dir = 1
	},
/obj/structure/window/reinforced{
	dir = 4
	},
/obj/structure/window/reinforced{
	dir = 8
	},
/obj/structure/flora/grass/jungle/b,
/obj/structure/flora/ausbushes/brflowers,
/turf/open/floor/grass,
/area/ruin/unpowered)
"sx" = (
/obj/effect/turf_decal/guideline/guideline_tri/blue{
	color = "#52B4E9";
	dir = 8
	},
/turf/open/floor/plasteel/white/side{
	dir = 4
	},
/area/ruin/unpowered)
"tl" = (
/obj/machinery/light,
/obj/effect/turf_decal/guideline/guideline_edge/blue,
/turf/open/floor/plasteel/white/side{
	dir = 1
	},
/area/ruin/unpowered)
"tq" = (
/obj/structure/sign/departments/medbay/alt{
	pixel_y = -32
	},
/obj/structure/sign/departments/medbay/alt{
	pixel_y = -32
	},
/turf/closed/wall/r_wall,
/area/ruin/unpowered)
"tv" = (
/obj/effect/spawner/structure/window/reinforced,
/turf/open/floor/plating,
/area/ruin/unpowered)
"ug" = (
/obj/effect/turf_decal/guideline/guideline_edge/blue,
/turf/open/floor/plasteel/white/side{
	dir = 1
	},
/area/ruin/unpowered)
"uI" = (
/obj/machinery/newscaster{
	pixel_x = 1;
	pixel_y = -30
	},
/obj/effect/turf_decal/guideline/guideline_edge/blue,
/turf/open/floor/plasteel/white/side{
	dir = 1
	},
/area/ruin/unpowered)
"uL" = (
/obj/effect/turf_decal/guideline/guideline_half_edge/blue{
	dir = 4
	},
/obj/effect/turf_decal/guideline/guideline_half_edge/blue{
	dir = 10
	},
/obj/effect/turf_decal/guideline/guideline_tri/blue{
	color = "#52B4E9"
	},
/obj/effect/turf_decal/guideline/guideline_edge_alt/blue{
	dir = 8
	},
/turf/open/floor/plasteel/white/side{
	dir = 10
	},
/area/ruin/unpowered)
"vg" = (
/obj/structure/extinguisher_cabinet{
	pixel_x = -32
	},
/obj/machinery/light{
	dir = 8
	},
/obj/effect/turf_decal/guideline/guideline_edge/blue{
	dir = 8
	},
/turf/open/floor/plasteel/white/side{
	dir = 8
	},
/area/ruin/unpowered)
"vq" = (
/obj/effect/turf_decal/guideline/guideline_edge/blue{
	dir = 1
	},
/turf/open/floor/plasteel/white/side,
/area/ruin/unpowered)
"vy" = (
/obj/effect/turf_decal/guideline/guideline_edge/blue,
/turf/open/floor/plasteel/white/side{
	dir = 9
	},
/area/ruin/unpowered)
"vH" = (
/obj/effect/turf_decal/tile/blue/fourcorners/contrasted,
/turf/open/floor/plasteel/white,
/area/ruin/unpowered)
"wC" = (
/obj/machinery/camera/autoname{
	dir = 8;
	network = list("ss13","medbay")
	},
/obj/effect/turf_decal/guideline/guideline_edge/blue{
	dir = 4
	},
/turf/open/floor/plasteel/white/side{
	dir = 4
	},
/area/ruin/unpowered)
"wT" = (
/turf/open/floor/plasteel,
/area/ruin/unpowered)
"zb" = (
/obj/effect/turf_decal/guideline/guideline_edge/blue{
	dir = 4
	},
/turf/open/floor/plasteel/white/corner{
	dir = 8
	},
/area/ruin/unpowered)
"zg" = (
/obj/item/radio/intercom{
	pixel_x = -27
	},
/obj/effect/turf_decal/guideline/guideline_edge/blue{
	dir = 8
	},
/turf/open/floor/plasteel/white/side{
	dir = 8
	},
/area/ruin/unpowered)
"At" = (
/obj/effect/decal/cleanable/blood/footprints{
	dir = 4;
	pixel_x = 6;
	pixel_y = 7
	},
/obj/effect/turf_decal/guideline/guideline_half_edge/blue{
	dir = 8
	},
/obj/effect/turf_decal/guideline/guideline_half_edge/blue{
	dir = 6
	},
/obj/effect/turf_decal/guideline/guideline_edge_alt/blue{
	dir = 4
	},
/obj/effect/turf_decal/guideline/guideline_tri/blue{
	color = "#52B4E9";
	dir = 1
	},
/turf/open/floor/plasteel/white/side{
	dir = 5
	},
/area/ruin/unpowered)
"AV" = (
/obj/effect/turf_decal/tile/blue/half{
	dir = 4
	},
/obj/effect/turf_decal/tile/blue/half{
	dir = 8
	},
/turf/open/floor/plasteel/white,
/area/ruin/unpowered)
"De" = (
/obj/structure/sign/warning/nosmoking,
/turf/closed/wall,
/area/ruin/unpowered)
"DT" = (
/obj/effect/turf_decal/delivery,
/obj/machinery/holopad,
/obj/machinery/iv_drip,
/obj/effect/turf_decal/box,
/turf/open/floor/plasteel/grid/steel,
/area/ruin/unpowered)
"EE" = (
/turf/open/floor/plasteel/white/side{
	dir = 4
	},
/area/ruin/unpowered)
"FU" = (
/turf/closed/wall/r_wall,
/area/ruin/unpowered)
"FW" = (
/obj/effect/decal/cleanable/blood/drip,
/turf/open/floor/plasteel/grid/steel,
/area/ruin/unpowered)
"Hq" = (
/obj/machinery/sleeper{
	dir = 4
	},
/obj/effect/turf_decal/delivery,
/turf/open/floor/plasteel/grid/steel,
/area/ruin/unpowered)
"Hu" = (
/obj/machinery/computer/operating{
	dir = 1
	},
/obj/effect/turf_decal/stripes/box,
/turf/open/floor/plasteel/grid/steel,
/area/ruin/unpowered)
"IO" = (
/turf/closed/wall,
/area/ruin/unpowered)
"IV" = (
/obj/structure/table/glass,
/obj/item/storage/box/masks{
	pixel_x = 2;
	pixel_y = -1
	},
/obj/item/storage/firstaid/regular{
	pixel_x = -3;
	pixel_y = -3
	},
/obj/machinery/light,
/turf/open/floor/plasteel,
/area/ruin/unpowered)
"JI" = (
/obj/machinery/shower{
	dir = 8;
	name = "emergency shower";
	pixel_x = -1;
	pixel_y = -8
	},
/obj/effect/turf_decal/bot,
/obj/effect/turf_decal/guideline/guideline_edge/blue{
	dir = 4
	},
/turf/open/floor/noslip/white,
/area/ruin/unpowered)
"JL" = (
/obj/effect/decal/cleanable/blood/old,
/turf/open/floor/plasteel,
/area/ruin/unpowered)
"KR" = (
/obj/machinery/door/firedoor,
/obj/effect/turf_decal/guideline/guideline_edge/blue,
/turf/open/floor/plasteel/white/side{
	dir = 1
	},
/area/ruin/unpowered)
"Lo" = (
/obj/machinery/door/firedoor,
/obj/effect/abstract/doorway_marker{
	dir = 8
	},
/turf/open/floor/plasteel/white,
/area/ruin/unpowered)
"LM" = (
/obj/machinery/vending/wallmed{
	pixel_x = -1;
	pixel_y = 32
	},
/obj/structure/sign/poster/official/cleanliness,
/turf/closed/wall,
/area/ruin/unpowered)
"LW" = (
/obj/machinery/status_display/evac{
	pixel_y = 32
	},
/obj/machinery/light{
	dir = 1
	},
/obj/structure/closet/secure_closet/personal/patient,
/obj/effect/turf_decal/bot{
	dir = 1
	},
/obj/effect/decal/cleanable/blood/old,
/turf/open/floor/plasteel,
/area/ruin/unpowered)
"Nf" = (
/obj/effect/turf_decal/tile/blue/half{
	dir = 4
	},
/obj/machinery/door/firedoor,
/obj/effect/abstract/open_area_marker{
	dir = 8
	},
/obj/effect/turf_decal/tile/blue/half{
	dir = 8
	},
/turf/open/floor/plasteel/white,
/area/ruin/unpowered)
"NL" = (
/turf/open/floor/plasteel/grid/steel,
/area/ruin/unpowered)
"Or" = (
/obj/effect/turf_decal/guideline/guideline_edge/blue{
	dir = 1
	},
/obj/effect/decal/cleanable/blood/old,
/turf/open/floor/plasteel/white/side,
/area/ruin/unpowered)
"OR" = (
/obj/effect/turf_decal/tile/blue/fourcorners/contrasted,
/mob/living/simple_animal/bot/cleanbot/larry{
	on = 0
	},
/turf/open/floor/plasteel/white,
/area/ruin/unpowered)
"Qg" = (
/obj/structure/table/glass,
/obj/item/reagent_containers/glass/bottle/epinephrine{
	pixel_x = 7;
	pixel_y = -3
	},
/obj/item/reagent_containers/syringe,
/obj/item/reagent_containers/spray/cleaner{
	pixel_x = -3;
	pixel_y = 2
	},
/obj/item/reagent_containers/syringe/antiviral,
/obj/item/reagent_containers/syringe/antiviral,
/obj/item/clothing/neck/stethoscope{
	pixel_y = 5
	},
/turf/open/floor/plasteel,
/area/ruin/unpowered)
"Qx" = (
/obj/effect/decal/cleanable/blood/old,
/turf/open/floor/plasteel/grid/steel,
/area/ruin/unpowered)
"Qy" = (
/obj/effect/spawner/structure/window/reinforced,
/obj/structure/curtain/directional{
	dir = 1
	},
/turf/open/floor/plating,
/area/ruin/unpowered)
"QH" = (
/obj/effect/turf_decal/tile/blue/fourcorners/contrasted,
/obj/effect/decal/cleanable/blood/footprints,
/turf/open/floor/plasteel/white,
/area/ruin/unpowered)
"Ra" = (
/obj/item/radio/intercom{
	dir = 1;
	pixel_x = -31;
	pixel_y = -3
	},
/obj/machinery/light{
	dir = 8
	},
/obj/effect/turf_decal/guideline/guideline_edge/blue{
	dir = 8
	},
/turf/open/floor/plasteel/white/side{
	dir = 8
	},
/area/ruin/unpowered)
"SP" = (
/obj/structure/flora/grass/jungle/b,
/obj/structure/flora/ausbushes/fullgrass,
/obj/structure/flora/ausbushes/brflowers,
/obj/structure/window/reinforced,
/obj/structure/window/reinforced{
	dir = 4
	},
/obj/structure/window/reinforced{
	dir = 8
	},
/turf/open/floor/grass,
/area/ruin/unpowered)
"Ts" = (
/obj/effect/turf_decal/guideline/guideline_edge/blue{
	dir = 8
	},
/turf/open/floor/plasteel/white/side{
	dir = 8
	},
/area/ruin/unpowered)
"Yh" = (
/obj/machinery/cryopod,
/obj/machinery/computer/cryopod{
	pixel_x = 33
	},
/turf/open/floor/plasteel/white/side{
	dir = 4
	},
/area/ruin/unpowered)
"YA" = (
/obj/machinery/door/firedoor,
/obj/effect/turf_decal/guideline/guideline_half_edge/blue{
	dir = 9
	},
/obj/effect/turf_decal/guideline/guideline_half_edge/blue{
	dir = 1
	},
/obj/effect/turf_decal/guideline/guideline_edge_alt/blue,
/obj/effect/turf_decal/guideline/guideline_tri/blue{
	color = "#52B4E9";
	dir = 4
	},
/turf/open/floor/plasteel/white/side{
	dir = 6
	},
/area/ruin/unpowered)
"YM" = (
/obj/effect/turf_decal/guideline/guideline_tri/blue{
	color = "#52B4E9";
	dir = 1
	},
/turf/open/floor/plasteel/white,
/area/ruin/unpowered)
"Zw" = (
/obj/effect/turf_decal/guideline/guideline_edge/blue{
	dir = 4
	},
/turf/open/floor/plasteel/white/side{
	dir = 4
	},
/area/ruin/unpowered)
"ZE" = (
/obj/effect/turf_decal/guideline/guideline_edge/blue{
	dir = 8
	},
/turf/open/floor/plasteel/white/corner,
/area/ruin/unpowered)
"ZX" = (
/obj/effect/turf_decal/guideline/guideline_edge/blue,
/turf/open/floor/plasteel/white,
/area/ruin/unpowered)
"ZZ" = (
/obj/effect/turf_decal/bot{
	dir = 1
	},
/obj/machinery/camera/autoname{
	dir = 2;
	network = list("ss13","medbay");
	view_range = 10
	},
/obj/structure/sink{
	dir = 1;
	pixel_y = 28
	},
/turf/open/floor/plasteel,
/area/ruin/unpowered)

(1,1,1) = {"
IO
Lo
tv
IO
IO
IO
YA
Nf
KR
IO
IO
IO
IO
IO
gN
tv
IO
"}
(2,1,1) = {"
Qy
ZE
Ts
hq
Ra
Ts
ee
vH
At
Ts
Ts
vg
zg
iU
YM
JL
IO
"}
(3,1,1) = {"
gu
vH
vH
QH
QH
vH
vH
vH
vH
vH
vH
vH
vH
OR
ZX
IV
IO
"}
(4,1,1) = {"
Qy
zb
pH
JI
sa
Zw
uL
vH
se
SP
vH
fT
wC
Zw
sx
Qg
IO
"}
(5,1,1) = {"
IO
IO
IO
IO
LM
fF
jy
vH
Hq
Hq
vH
tl
IO
IO
IO
IO
IO
"}
(6,1,1) = {"
bp
bp
bp
bp
IO
ZZ
vq
vH
NL
FW
vH
uI
IO
bp
bp
bp
bp
"}
(7,1,1) = {"
bp
bp
bp
bp
tv
hU
vq
vH
pp
DT
vH
ug
IO
bp
bp
bp
bp
"}
(8,1,1) = {"
bp
bp
bp
bp
tv
wT
vq
vH
Qx
NL
vH
ug
IO
bp
bp
bp
bp
"}
(9,1,1) = {"
bp
bp
bp
bp
tv
wT
vq
vH
iT
gt
vH
ug
IO
bp
bp
bp
bp
"}
(10,1,1) = {"
bp
bp
bp
bp
De
pP
vq
vH
Hu
IO
vH
dp
IO
bp
bp
bp
bp
"}
(11,1,1) = {"
bp
bp
bp
bp
FU
LW
Or
vH
vH
vH
vH
tl
ef
bp
bp
bp
bp
"}
(12,1,1) = {"
bp
bp
bp
bp
tv
pP
vq
AV
kV
cO
fh
du
IO
bp
bp
bp
bp
"}
(13,1,1) = {"
bp
bp
bp
bp
tv
cq
vq
AV
vy
EE
Yh
rp
IO
bp
bp
bp
bp
"}
(14,1,1) = {"
bp
bp
bp
bp
tq
FU
YA
fl
KR
IO
IO
IO
IO
bp
bp
bp
bp
"}
