//MAP CONVERTED BY dmm2tgm.py THIS HEADER COMMENT PREVENTS RECONVERSION, DO NOT REMOVE
"e" = (
/turf/closed/wall,
/area/ruin/unpowered)
"f" = (
/obj/effect/spawner/lootdrop/storage,
/obj/effect/turf_decal/bot,
/obj/machinery/newscaster{
	pixel_x = 32
	},
/obj/machinery/firealarm/directional/north,
/turf/open/floor/iron,
/area/ruin/unpowered)
"i" = (
/obj/machinery/atmospherics/components/unary/vent_pump/on/layer2{
	dir = 1
	},
/obj/machinery/atmospherics/pipe/simple/scrubbers/hidden/layer4,
/turf/open/floor/iron,
/area/ruin/unpowered)
"j" = (
/obj/effect/abstract/doorway_marker{
	dir = 1
	},
/turf/open/floor/iron,
/area/ruin/unpowered)
"k" = (
/obj/effect/decal/cleanable/oil,
/obj/machinery/light_switch{
	pixel_x = -25;
	pixel_y = 25
	},
/obj/effect/turf_decal/delivery,
/obj/machinery/atmospherics/pipe/simple/scrubbers/hidden/layer4,
/obj/machinery/atmospherics/pipe/simple/supply/hidden/layer2,
/turf/open/floor/iron,
/area/ruin/unpowered)
"y" = (
/obj/machinery/airalarm/directional/east,
/obj/effect/spawner/lootdrop/storage,
/obj/effect/turf_decal/bot,
/turf/open/floor/iron,
/area/ruin/unpowered)
"z" = (
/obj/effect/decal/cleanable/oil/streak,
/obj/effect/spawner/lootdrop/storage,
/obj/effect/turf_decal/bot,
/turf/open/floor/iron,
/area/ruin/unpowered)
"G" = (
/obj/effect/decal/cleanable/blood/drip,
/obj/effect/spawner/lootdrop/storage,
/obj/effect/turf_decal/bot,
/obj/machinery/light/small{
	dir = 8
	},
/turf/open/floor/iron,
/area/ruin/unpowered)
"W" = (
/obj/effect/spawner/lootdrop/maintenance,
/obj/item/radio/intercom{
	pixel_y = -26
	},
/obj/machinery/atmospherics/components/unary/vent_scrubber/on/layer4{
	dir = 1
	},
/turf/open/floor/iron,
/area/ruin/unpowered)
"X" = (
/obj/effect/spawner/lootdrop/storage,
/obj/effect/turf_decal/bot,
/obj/structure/sign/departments/minsky/supply/cargo{
	pixel_x = -32
	},
/turf/open/floor/iron,
/area/ruin/unpowered)
"Y" = (
/obj/effect/spawner/lootdrop/storage,
/obj/effect/turf_decal/bot,
/obj/structure/extinguisher_cabinet{
	pixel_x = -26
	},
/turf/open/floor/iron,
/area/ruin/unpowered)

(1,1,1) = {"
e
e
e
e
e
"}
(2,1,1) = {"
e
X
G
Y
e
"}
(3,1,1) = {"
j
k
i
W
e
"}
(4,1,1) = {"
e
f
y
z
e
"}
(5,1,1) = {"
e
e
e
e
e
"}
