//MAP CONVERTED BY dmm2tgm.py THIS HEADER COMMENT PREVENTS RECONVERSION, DO NOT REMOVE
"c" = (
/obj/structure/urinal{
	pixel_y = 32
	},
/turf/open/floor/iron,
/area/ruin/unpowered)
"g" = (
/obj/machinery/firealarm/directional/south,
/turf/open/floor/iron,
/area/ruin/unpowered)
"p" = (
/obj/machinery/atmospherics/pipe/simple/supply/hidden/layer2{
	dir = 4
	},
/obj/machinery/atmospherics/pipe/simple/scrubbers/hidden/layer4{
	dir = 4
	},
/obj/effect/turf_decal/delivery,
/obj/machinery/light_switch{
	pixel_x = -25;
	pixel_y = -25
	},
/turf/open/floor/iron,
/area/ruin/unpowered)
"q" = (
/turf/closed/wall,
/area/ruin/unpowered)
"A" = (
/obj/structure/mirror{
	pixel_x = 28
	},
/obj/structure/sink{
	dir = 4;
	pixel_x = 11
	},
/obj/structure/sign/poster/random{
	pixel_y = 32
	},
/turf/open/floor/iron,
/area/ruin/unpowered)
"C" = (
/obj/machinery/atmospherics/components/unary/vent_pump/on/layer2{
	dir = 8
	},
/obj/machinery/airalarm/directional/east,
/turf/open/floor/iron,
/area/ruin/unpowered)
"G" = (
/obj/machinery/atmospherics/pipe/simple/supply/hidden/layer2{
	dir = 4
	},
/obj/machinery/atmospherics/components/unary/vent_scrubber/on/layer4{
	dir = 8
	},
/turf/open/floor/iron,
/area/ruin/unpowered)
"K" = (
/obj/effect/abstract/doorway_marker{
	dir = 8
	},
/obj/structure/sign/departments/restroom{
	pixel_y = 32
	},
/turf/open/floor/iron,
/area/ruin/unpowered)
"M" = (
/obj/item/radio/intercom{
	pixel_y = -26
	},
/turf/open/floor/iron,
/area/ruin/unpowered)
"X" = (
/obj/structure/toilet{
	dir = 8
	},
/obj/structure/window/reinforced/spawner/north,
/obj/machinery/newscaster{
	pixel_x = 32
	},
/obj/machinery/door/window/westleft,
/turf/open/floor/iron,
/area/ruin/unpowered)

(1,1,1) = {"
q
q
K
q
q
"}
(2,1,1) = {"
q
c
p
g
q
"}
(3,1,1) = {"
q
c
G
M
q
"}
(4,1,1) = {"
q
A
C
X
q
"}
(5,1,1) = {"
q
q
q
q
q
"}
