//MAP CONVERTED BY dmm2tgm.py THIS HEADER COMMENT PREVENTS RECONVERSION, DO NOT REMOVE
"a" = (
/obj/structure/closet/secure_closet/personal,
/obj/effect/turf_decal/guideline/guideline_edge/blue{
	color = "#267878"
	},
/turf/open/floor/iron,
/area/ruin/unpowered)
"c" = (
/obj/machinery/cryopod,
/obj/effect/turf_decal/bot,
/obj/effect/turf_decal/guideline/guideline_edge/blue{
	color = "#267878";
	dir = 1
	},
/turf/open/floor/iron,
/area/ruin/unpowered)
"f" = (
/obj/effect/turf_decal/delivery,
/obj/effect/turf_decal/guideline/guideline_edge/blue{
	color = "#267878";
	dir = 1
	},
/turf/open/floor/iron,
/area/ruin/unpowered)
"q" = (
/obj/machinery/door/airlock/public/glass{
	name = "Cryogenic Lounge"
	},
/obj/effect/turf_decal/tile/blue/fourcorners/contrasted{
	alpha = 200;
	color = "#267878"
	},
/obj/effect/abstract/doorway_marker{
	dir = 8
	},
/turf/open/floor/iron,
/area/ruin/unpowered)
"s" = (
/obj/effect/spawner/structure/window,
/turf/open/floor/plating,
/area/ruin/unpowered)
"v" = (
/turf/closed/wall,
/area/ruin/unpowered)
"z" = (
/obj/machinery/computer/cryopod{
	pixel_x = 32
	},
/obj/effect/turf_decal/tile/blue/fourcorners/contrasted{
	alpha = 200;
	color = "#267878"
	},
/obj/machinery/light{
	dir = 4
	},
/turf/open/floor/iron,
/area/ruin/unpowered)
"D" = (
/obj/structure/closet/secure_closet/personal,
/obj/item/radio/intercom{
	dir = 1;
	pixel_x = 1;
	pixel_y = 23
	},
/obj/effect/turf_decal/guideline/guideline_edge/blue{
	color = "#267878";
	dir = 1
	},
/turf/open/floor/iron,
/area/ruin/unpowered)
"P" = (
/obj/effect/turf_decal/tile/blue/fourcorners/contrasted{
	alpha = 200;
	color = "#267878"
	},
/turf/open/floor/iron,
/area/ruin/unpowered)
"Q" = (
/obj/effect/turf_decal/delivery,
/obj/effect/turf_decal/guideline/guideline_edge/blue{
	color = "#267878"
	},
/turf/open/floor/iron,
/area/ruin/unpowered)
"R" = (
/obj/machinery/cryopod,
/obj/effect/turf_decal/bot,
/obj/effect/turf_decal/guideline/guideline_edge/blue{
	color = "#267878"
	},
/turf/open/floor/iron,
/area/ruin/unpowered)
"X" = (
/obj/structure/sign/poster/random{
	pixel_x = 2
	},
/turf/closed/wall,
/area/ruin/unpowered)

(1,1,1) = {"
v
s
q
s
v
"}
(2,1,1) = {"
v
D
P
a
X
"}
(3,1,1) = {"
v
f
P
Q
v
"}
(4,1,1) = {"
v
c
z
R
v
"}
(5,1,1) = {"
v
v
v
v
v
"}
