//MAP CONVERTED BY dmm2tgm.py THIS HEADER COMMENT PREVENTS RECONVERSION, DO NOT REMOVE
"b" = (
/obj/effect/turf_decal/tile/neutral/fourcorners/contrasted,
/turf/open/floor/iron/dark,
/area/ruin/unpowered)
"c" = (
/obj/effect/turf_decal/stripes/line,
/turf/open/floor/iron,
/area/ruin/unpowered)
"g" = (
/obj/machinery/gateway{
	dir = 10
	},
/obj/effect/turf_decal/bot_white/left,
/obj/effect/turf_decal/tile/neutral/fourcorners/contrasted,
/turf/open/floor/iron/dark,
/area/ruin/unpowered)
"h" = (
/turf/closed/wall/r_wall,
/area/ruin/unpowered)
"i" = (
/obj/machinery/gateway{
	dir = 6
	},
/obj/effect/turf_decal/bot_white/right,
/obj/effect/turf_decal/tile/neutral/fourcorners/contrasted,
/turf/open/floor/iron/dark,
/area/ruin/unpowered)
"o" = (
/obj/machinery/gateway,
/obj/effect/turf_decal/bot_white,
/obj/effect/turf_decal/tile/neutral/fourcorners/contrasted,
/turf/open/floor/iron/dark,
/area/ruin/unpowered)
"q" = (
/turf/open/floor/iron,
/area/ruin/unpowered)
"u" = (
/obj/machinery/gateway{
	dir = 5
	},
/obj/effect/turf_decal/bot_white/left,
/obj/effect/turf_decal/tile/neutral/fourcorners/contrasted,
/turf/open/floor/iron/dark,
/area/ruin/unpowered)
"x" = (
/obj/machinery/gateway{
	dir = 9
	},
/obj/effect/turf_decal/bot_white/right,
/obj/effect/turf_decal/tile/neutral/fourcorners/contrasted,
/turf/open/floor/iron/dark,
/area/ruin/unpowered)
"A" = (
/obj/effect/turf_decal/stripes/line{
	dir = 1
	},
/obj/machinery/button/door{
	id = "gatewayshutters";
	name = "Gateway Shutters";
	req_access_txt = "19";
	pixel_x = -25
	},
/turf/open/floor/iron,
/area/ruin/unpowered)
"D" = (
/obj/machinery/door/poddoor/shutters{
	id = "gatewayshutters";
	name = "Gateway Access Shutter"
	},
/obj/effect/turf_decal/delivery,
/obj/machinery/door/firedoor/border_only,
/turf/open/floor/iron,
/area/ruin/unpowered)
"E" = (
/obj/machinery/gateway{
	dir = 1
	},
/obj/machinery/status_display/evac{
	pixel_y = 32
	},
/obj/effect/turf_decal/bot_white,
/obj/effect/turf_decal/tile/neutral/fourcorners/contrasted,
/turf/open/floor/iron/dark,
/area/ruin/unpowered)
"F" = (
/obj/effect/turf_decal/stripes/line,
/obj/machinery/button/door{
	id = "gatewayshutters";
	name = "Gateway Shutters";
	req_access_txt = "19";
	pixel_x = -25
	},
/turf/open/floor/iron,
/area/ruin/unpowered)
"H" = (
/obj/machinery/gateway{
	dir = 8
	},
/obj/effect/turf_decal/bot_white,
/obj/effect/turf_decal/tile/neutral/fourcorners/contrasted,
/turf/open/floor/iron/dark,
/area/ruin/unpowered)
"I" = (
/obj/machinery/gateway{
	dir = 4
	},
/obj/effect/turf_decal/bot_white,
/obj/effect/turf_decal/tile/neutral/fourcorners/contrasted,
/turf/open/floor/iron/dark,
/area/ruin/unpowered)
"P" = (
/obj/effect/abstract/open_area_marker,
/turf/open/floor/iron,
/area/ruin/unpowered)
"Q" = (
/obj/effect/turf_decal/stripes/line{
	dir = 1
	},
/turf/open/floor/iron,
/area/ruin/unpowered)
"X" = (
/obj/effect/turf_decal/delivery,
/obj/machinery/door/firedoor/border_only,
/obj/machinery/door/poddoor/shutters{
	id = "gatewayshutters";
	name = "Gateway Access Shutter"
	},
/turf/open/floor/iron,
/area/ruin/unpowered)
"Z" = (
/obj/machinery/gateway/centeraway,
/turf/open/floor/iron/dark,
/area/ruin/unpowered)

(1,1,1) = {"
h
h
h
h
h
h
h
h
h
"}
(2,1,1) = {"
h
x
H
g
b
F
D
A
q
"}
(3,1,1) = {"
h
E
Z
o
b
c
X
Q
P
"}
(4,1,1) = {"
h
u
I
i
b
c
X
Q
q
"}
(5,1,1) = {"
h
h
h
h
h
h
h
h
h
"}
