//MAP CONVERTED BY dmm2tgm.py THIS HEADER COMMENT PREVENTS RECONVERSION, DO NOT REMOVE
"a" = (
/obj/effect/turf_decal/stripes/line{
	dir = 5
	},
/turf/open/floor/plasteel,
/area/space)
"c" = (
/obj/machinery/portable_atmospherics/canister/plasma,
/obj/effect/turf_decal/bot,
/turf/open/floor/plasteel,
/area/space)
"f" = (
/obj/effect/turf_decal/bot,
/turf/open/floor/plasteel,
/area/space)
"g" = (
/obj/effect/turf_decal/delivery,
/turf/open/floor/plasteel,
/area/space)
"i" = (
/obj/machinery/portable_atmospherics/canister/plasma,
/obj/effect/turf_decal/bot,
/obj/machinery/light,
/turf/open/floor/plasteel,
/area/space)
"j" = (
/obj/machinery/portable_atmospherics/canister/carbon_dioxide,
/obj/effect/turf_decal/bot,
/turf/open/floor/plasteel,
/area/space)
"k" = (
/obj/structure/sign/warning/fire,
/turf/closed/wall/r_wall,
/area/space)
"l" = (
/obj/structure/sign/warning/securearea,
/turf/closed/wall/r_wall,
/area/space)
"n" = (
/obj/machinery/portable_atmospherics/scrubber/huge,
/obj/effect/decal/cleanable/dirt,
/obj/effect/turf_decal/bot,
/turf/open/floor/plasteel,
/area/space)
"q" = (
/obj/effect/turf_decal/stripes/line{
	dir = 10
	},
/turf/open/floor/plasteel,
/area/space)
"r" = (
/obj/item/radio/intercom{
	pixel_y = 26
	},
/obj/machinery/portable_atmospherics/canister/nitrogen,
/obj/effect/turf_decal/bot,
/turf/open/floor/plasteel,
/area/space)
"t" = (
/obj/effect/turf_decal/stripes/line,
/obj/machinery/portable_atmospherics/canister,
/turf/open/floor/plasteel,
/area/space)
"u" = (
/obj/effect/decal/cleanable/dirt,
/obj/effect/turf_decal/stripes/line{
	dir = 1
	},
/turf/open/floor/plasteel,
/area/space)
"v" = (
/obj/effect/decal/cleanable/dirt,
/obj/effect/turf_decal/bot,
/turf/open/floor/plasteel,
/area/space)
"x" = (
/obj/machinery/portable_atmospherics/canister/oxygen,
/obj/effect/decal/cleanable/dirt,
/obj/effect/turf_decal/bot,
/turf/open/floor/plasteel,
/area/space)
"y" = (
/obj/structure/table,
/obj/machinery/light{
	dir = 1
	},
/obj/effect/decal/cleanable/dirt,
/obj/item/crowbar,
/obj/item/wrench,
/obj/item/clothing/mask/gas,
/obj/structure/extinguisher_cabinet{
	pixel_x = 26
	},
/obj/effect/turf_decal/bot,
/turf/open/floor/plasteel,
/area/space)
"A" = (
/obj/effect/decal/cleanable/dirt,
/obj/effect/turf_decal/delivery,
/turf/open/floor/plasteel,
/area/space)
"B" = (
/obj/effect/turf_decal/stripes/line{
	dir = 8
	},
/turf/open/floor/plasteel,
/area/space)
"C" = (
/obj/machinery/portable_atmospherics/canister/nitrous_oxide,
/obj/effect/decal/cleanable/dirt,
/obj/effect/turf_decal/bot,
/turf/open/floor/plasteel,
/area/space)
"E" = (
/obj/effect/turf_decal/stripes/line,
/turf/open/floor/plasteel,
/area/space)
"F" = (
/obj/structure/extinguisher_cabinet{
	pixel_x = -26
	},
/obj/effect/turf_decal/stripes/line{
	dir = 9
	},
/turf/open/floor/plasteel,
/area/space)
"G" = (
/obj/machinery/portable_atmospherics/canister/oxygen,
/obj/effect/turf_decal/bot,
/turf/open/floor/plasteel,
/area/space)
"I" = (
/obj/machinery/portable_atmospherics/canister/plasma,
/obj/effect/decal/cleanable/dirt,
/obj/effect/turf_decal/bot,
/turf/open/floor/plasteel,
/area/space)
"J" = (
/obj/machinery/door/airlock/research{
	name = "Toxins Secure Storage";
	req_access_txt = "8"
	},
/obj/machinery/door/poddoor/shutters/preopen{
	id = "rdtoxins";
	name = "Toxins Lab Shutters"
	},
/obj/effect/turf_decal/stripes/line{
	dir = 8
	},
/obj/effect/turf_decal/stripes/line{
	dir = 4
	},
/obj/machinery/door/firedoor,
/obj/effect/abstract/doorway_marker{
	dir = 8
	},
/turf/open/floor/plasteel,
/area/space)
"K" = (
/obj/machinery/portable_atmospherics/canister/oxygen,
/obj/effect/decal/cleanable/dirt,
/obj/effect/turf_decal/bot,
/obj/machinery/light,
/turf/open/floor/plasteel,
/area/space)
"L" = (
/obj/effect/decal/cleanable/dirt,
/obj/effect/turf_decal/stripes/line{
	dir = 8
	},
/turf/open/floor/plasteel,
/area/space)
"M" = (
/turf/closed/wall/r_wall,
/area/space)
"P" = (
/obj/effect/turf_decal/stripes/line{
	dir = 6
	},
/turf/open/floor/plasteel,
/area/space)
"R" = (
/obj/effect/turf_decal/stripes/line{
	dir = 1
	},
/turf/open/floor/plasteel,
/area/space)
"S" = (
/obj/structure/filingcabinet/chestdrawer,
/obj/machinery/light{
	dir = 1
	},
/obj/effect/decal/cleanable/dirt,
/obj/effect/turf_decal/bot,
/turf/open/floor/plasteel,
/area/space)
"V" = (
/obj/machinery/camera{
	c_tag = "Science - Toxins Secure Storage";
	dir = 4;
	name = "science camera";
	network = list("ss13","rd")
	},
/obj/effect/turf_decal/bot,
/obj/machinery/portable_atmospherics/pump{
	name = "Lil Pump"
	},
/turf/open/floor/plasteel,
/area/space)
"Z" = (
/obj/effect/decal/cleanable/dirt,
/obj/machinery/door/poddoor/shutters/preopen{
	id = "rdtoxins";
	name = "Toxins Lab Shutters"
	},
/obj/effect/turf_decal/stripes/line,
/obj/effect/turf_decal/stripes/line{
	dir = 1
	},
/obj/machinery/door/airlock/research{
	name = "Toxins Secure Storage";
	req_access_txt = "8"
	},
/obj/machinery/door/firedoor,
/obj/effect/abstract/doorway_marker{
	dir = 1
	},
/turf/open/floor/plasteel,
/area/space)

(1,1,1) = {"
M
M
M
k
J
l
M
M
M
M
M
"}
(2,1,1) = {"
k
S
F
q
g
V
j
G
f
K
M
"}
(3,1,1) = {"
Z
A
u
t
A
f
f
f
G
x
M
"}
(4,1,1) = {"
M
v
u
E
L
B
B
B
L
L
M
"}
(5,1,1) = {"
M
r
R
E
A
f
f
c
v
I
M
"}
(6,1,1) = {"
M
y
a
P
g
n
C
f
c
i
M
"}
(7,1,1) = {"
M
M
M
M
M
M
M
M
M
M
M
"}
