//MAP CONVERTED BY dmm2tgm.py THIS HEADER COMMENT PREVENTS RECONVERSION, DO NOT REMOVE
"a" = (
/turf/closed/wall,
/area/ruin/unpowered)
"b" = (
/turf/template_noop,
/area/template_noop)
"c" = (
/obj/effect/turf_decal/bot,
/obj/effect/turf_decal/tile/neutral,
/turf/open/floor/plasteel/dark,
/area/ruin/unpowered)
"d" = (
/obj/effect/turf_decal/tile/dark_blue/half/contrasted{
	alpha = 180;
	dir = 8
	},
/turf/open/floor/plasteel,
/area/ruin/unpowered)
"e" = (
/obj/effect/turf_decal/bot,
/obj/structure/tank_dispenser/oxygen{
	pixel_x = -1;
	pixel_y = 2;
	oxygentanks = 3
	},
/turf/open/floor/plasteel,
/area/ruin/unpowered)
"f" = (
/obj/structure/table,
/obj/machinery/cell_charger,
/obj/machinery/camera{
	c_tag = "Teleporter Access";
	dir = 4;
	name = "command camera"
	},
/obj/effect/turf_decal/tile/neutral/half/contrasted,
/turf/open/floor/plasteel/dark,
/area/ruin/unpowered)
"g" = (
/obj/effect/turf_decal/bot,
/obj/effect/turf_decal/tile/neutral/half/contrasted,
/turf/open/floor/plasteel/dark,
/area/ruin/unpowered)
"h" = (
/obj/effect/spawner/structure/window/reinforced,
/turf/open/floor/plating,
/area/ruin/unpowered)
"k" = (
/obj/effect/turf_decal/bot,
/obj/structure/table,
/obj/item/gps{
	gpstag = "TP0"
	},
/turf/open/floor/plasteel,
/area/ruin/unpowered)
"l" = (
/obj/effect/turf_decal/stripes/line{
	dir = 1
	},
/turf/open/floor/plasteel,
/area/ruin/unpowered)
"m" = (
/obj/effect/turf_decal/loading_area{
	dir = 4
	},
/obj/effect/turf_decal/stripes/corner,
/obj/effect/turf_decal/tile/neutral,
/turf/open/floor/plasteel,
/area/ruin/unpowered)
"n" = (
/obj/machinery/door/firedoor,
/obj/machinery/door/airlock/command{
	name = "Teleporter Access";
	req_one_access_txt = "17;19"
	},
/obj/effect/abstract/doorway_marker{
	dir = 8
	},
/turf/open/floor/plasteel/dark,
/area/ruin/unpowered)
"o" = (
/obj/machinery/shieldwallgen,
/obj/effect/turf_decal/bot,
/obj/machinery/light{
	dir = 8
	},
/obj/effect/turf_decal/tile/neutral/half/contrasted,
/turf/open/floor/plasteel/dark,
/area/ruin/unpowered)
"p" = (
/obj/effect/turf_decal/stripes/line{
	dir = 8
	},
/obj/effect/turf_decal/tile/neutral{
	dir = 1
	},
/turf/open/floor/plasteel,
/area/ruin/unpowered)
"q" = (
/obj/effect/turf_decal/bot,
/obj/structure/extinguisher_cabinet{
	pixel_x = 24
	},
/obj/structure/sign/warning/fire{
	pixel_y = 32
	},
/obj/effect/turf_decal/tile/neutral/half/contrasted{
	dir = 1
	},
/turf/open/floor/plasteel/dark,
/area/ruin/unpowered)
"r" = (
/obj/effect/turf_decal/delivery,
/obj/structure/closet/crate/engineering,
/obj/effect/turf_decal/tile/neutral/half/contrasted{
	dir = 8
	},
/obj/item/beacon,
/turf/open/floor/plasteel/dark,
/area/ruin/unpowered)
"s" = (
/obj/effect/decal/cleanable/dirt,
/obj/machinery/shieldwallgen,
/turf/open/floor/plasteel,
/area/ruin/unpowered)
"t" = (
/obj/effect/turf_decal/tile/neutral/half/contrasted{
	dir = 1
	},
/obj/machinery/shieldwallgen,
/turf/open/floor/plasteel/dark,
/area/ruin/unpowered)
"u" = (
/obj/effect/turf_decal/stripes/line{
	dir = 1
	},
/obj/effect/turf_decal/stripes/corner{
	dir = 8
	},
/obj/effect/turf_decal/tile/neutral{
	dir = 1
	},
/turf/open/floor/plasteel,
/area/ruin/unpowered)
"w" = (
/obj/machinery/button/door{
	id = "teleshutter";
	name = "Teleporter Shutter Toggle";
	pixel_x = -8;
	pixel_y = 24;
	req_access_txt = "19"
	},
/obj/machinery/camera{
	c_tag = "Central Hallway Teleporter Access";
	name = "central camera"
	},
/obj/effect/turf_decal/tile/dark_blue/half/contrasted{
	alpha = 180;
	dir = 4
	},
/turf/open/floor/plasteel,
/area/ruin/unpowered)
"x" = (
/obj/effect/turf_decal/stripes/corner{
	dir = 4
	},
/obj/effect/turf_decal/tile/dark_blue/half/contrasted{
	alpha = 180;
	dir = 4
	},
/turf/open/floor/plasteel,
/area/ruin/unpowered)
"z" = (
/obj/effect/turf_decal/stripes/corner{
	dir = 4
	},
/obj/effect/turf_decal/tile/neutral,
/turf/open/floor/plasteel,
/area/ruin/unpowered)
"A" = (
/obj/machinery/teleport/hub,
/obj/effect/turf_decal/delivery,
/obj/effect/turf_decal/tile/neutral/half/contrasted{
	dir = 1
	},
/turf/open/floor/plasteel/dark,
/area/ruin/unpowered)
"B" = (
/obj/machinery/door/airlock/maintenance{
	name = "command maintenance";
	req_one_access_txt = "17;19"
	},
/obj/effect/abstract/doorway_marker{
	dir = 4
	},
/turf/open/floor/plating,
/area/ruin/unpowered)
"D" = (
/obj/effect/turf_decal/stripes/line{
	dir = 1
	},
/obj/effect/turf_decal/tile/dark_blue/half/contrasted{
	alpha = 180;
	dir = 4
	},
/turf/open/floor/plasteel,
/area/ruin/unpowered)
"E" = (
/obj/effect/decal/cleanable/dirt,
/obj/effect/turf_decal/stripes/line{
	dir = 5
	},
/turf/open/floor/plasteel,
/area/ruin/unpowered)
"F" = (
/obj/effect/turf_decal/stripes/corner{
	dir = 4
	},
/obj/effect/turf_decal/stripes/corner{
	dir = 1
	},
/obj/effect/turf_decal/tile/dark_blue/half/contrasted{
	alpha = 180;
	dir = 4
	},
/turf/open/floor/plasteel,
/area/ruin/unpowered)
"G" = (
/obj/effect/decal/cleanable/dirt,
/obj/effect/turf_decal/stripes/line{
	dir = 8
	},
/obj/effect/turf_decal/tile/neutral{
	dir = 1
	},
/turf/open/floor/plasteel,
/area/ruin/unpowered)
"H" = (
/obj/effect/abstract/open_area_marker{
	dir = 4
	},
/turf/open/floor/plasteel,
/area/ruin/unpowered)
"I" = (
/obj/effect/turf_decal/stripes/corner{
	dir = 1
	},
/obj/effect/turf_decal/tile/dark_blue/half/contrasted{
	alpha = 180;
	dir = 4
	},
/turf/open/floor/plasteel,
/area/ruin/unpowered)
"J" = (
/obj/structure/rack,
/obj/item/wrench,
/obj/item/stack/package_wrap,
/obj/effect/turf_decal/tile/neutral/half/contrasted,
/turf/open/floor/plasteel/dark,
/area/ruin/unpowered)
"K" = (
/obj/machinery/computer/teleporter{
	dir = 8
	},
/obj/machinery/button/door{
	id = "teleshutter";
	name = "Teleporter Shutter Toggle";
	pixel_x = 24;
	pixel_y = -24;
	req_access_txt = "19"
	},
/obj/effect/turf_decal/bot,
/obj/effect/turf_decal/tile/neutral/half/contrasted{
	dir = 1
	},
/turf/open/floor/plasteel/dark,
/area/ruin/unpowered)
"L" = (
/obj/effect/abstract/open_area_marker{
	dir = 8
	},
/turf/open/floor/plasteel,
/area/ruin/unpowered)
"M" = (
/turf/open/floor/plasteel,
/area/ruin/unpowered)
"N" = (
/obj/effect/turf_decal/bot,
/obj/machinery/holopad,
/turf/open/floor/plasteel,
/area/ruin/unpowered)
"P" = (
/obj/machinery/teleport/station,
/obj/machinery/status_display/evac{
	pixel_x = 32
	},
/obj/machinery/light{
	dir = 4
	},
/obj/effect/turf_decal/tile/neutral/half/contrasted{
	dir = 1
	},
/turf/open/floor/plasteel/dark,
/area/ruin/unpowered)
"Q" = (
/obj/effect/turf_decal/stripes/line{
	dir = 4
	},
/obj/effect/turf_decal/tile/neutral,
/obj/effect/decal/cleanable/glass,
/turf/open/floor/plasteel,
/area/ruin/unpowered)
"R" = (
/obj/machinery/door/poddoor/shutters{
	id = "teleshutter";
	name = "Teleporter Access Shutter"
	},
/obj/effect/turf_decal/caution/stand_clear,
/turf/open/floor/plasteel/dark,
/area/ruin/unpowered)
"T" = (
/obj/effect/turf_decal/tile/neutral/half/contrasted,
/obj/effect/decal/cleanable/glass,
/turf/open/floor/plasteel/dark,
/area/ruin/unpowered)
"U" = (
/obj/machinery/bluespace_beacon,
/obj/effect/turf_decal/stripes/line{
	dir = 4
	},
/obj/effect/turf_decal/tile/neutral,
/turf/open/floor/plasteel,
/area/ruin/unpowered)
"W" = (
/obj/machinery/door/firedoor,
/obj/machinery/door/airlock/command/glass{
	name = "Teleporter Access";
	req_one_access_txt = "17;19"
	},
/turf/open/floor/plasteel/dark,
/area/ruin/unpowered)
"X" = (
/obj/effect/turf_decal/bot,
/obj/structure/window/reinforced{
	dir = 8
	},
/obj/machinery/light/small{
	dir = 1
	},
/obj/effect/turf_decal/tile/neutral/half/contrasted{
	dir = 8
	},
/turf/open/floor/plasteel/dark,
/area/ruin/unpowered)
"Y" = (
/obj/structure/sign/warning/securearea{
	pixel_y = 32
	},
/obj/machinery/light{
	dir = 1
	},
/obj/effect/turf_decal/tile/dark_blue/half/contrasted{
	alpha = 180;
	dir = 4
	},
/turf/open/floor/plasteel,
/area/ruin/unpowered)
"Z" = (
/turf/closed/wall/r_wall,
/area/ruin/unpowered)

(1,1,1) = {"
Z
Z
n
Z
Z
Z
Z
Z
Y
L
d
a
"}
(2,1,1) = {"
Z
c
T
J
o
f
g
h
x
M
d
a
"}
(3,1,1) = {"
Z
r
u
p
G
p
p
R
D
M
d
a
"}
(4,1,1) = {"
Z
X
l
k
N
e
s
h
F
M
d
a
"}
(5,1,1) = {"
Z
Z
E
z
m
U
Q
W
D
M
d
a
"}
(6,1,1) = {"
b
Z
q
t
A
P
K
h
I
M
d
a
"}
(7,1,1) = {"
b
Z
Z
B
Z
Z
Z
Z
w
H
d
a
"}
