//MAP CONVERTED BY dmm2tgm.py THIS HEADER COMMENT PREVENTS RECONVERSION, DO NOT REMOVE
"a" = (
/obj/effect/turf_decal/stripes/line,
/obj/effect/turf_decal/tile/neutral/half/contrasted{
	dir = 8
	},
/obj/structure/closet/secure_closet/medical3{
	req_access = null;
	req_access_txt = "5"
	},
/turf/open/floor/plasteel,
/area/ruin/unpowered)
"b" = (
/obj/machinery/light{
	dir = 1
	},
/obj/effect/turf_decal/stripes/line{
	dir = 10
	},
/obj/structure/frame/machine,
/turf/open/floor/plasteel/grid/steel,
/area/ruin/unpowered)
"c" = (
/obj/machinery/door/airlock/medical/glass{
	name = "Medbay Storage";
	req_access_txt = "5"
	},
/obj/machinery/door/firedoor,
/obj/effect/turf_decal/delivery,
/obj/effect/turf_decal/stripes/line{
	dir = 4
	},
/obj/effect/turf_decal/stripes/line{
	dir = 8
	},
/turf/open/floor/plasteel/grid/steel,
/area/ruin/unpowered)
"f" = (
/obj/effect/spawner/structure/window/reinforced,
/turf/open/floor/plating,
/area/ruin/unpowered)
"g" = (
/obj/effect/abstract/doorway_marker{
	dir = 4
	},
/turf/open/floor/plasteel,
/area/ruin/unpowered)
"i" = (
/obj/structure/sign/warning/nosmoking,
/turf/closed/wall,
/area/ruin/unpowered)
"j" = (
/obj/machinery/holopad{
	pixel_x = 16;
	pixel_y = 16
	},
/turf/open/floor/plasteel/grid/steel,
/area/ruin/unpowered)
"k" = (
/obj/structure/sign/warning/biohazard,
/turf/closed/wall/r_wall,
/area/ruin/unpowered)
"m" = (
/obj/structure/table/glass,
/obj/structure/window/reinforced{
	dir = 8
	},
/obj/structure/window/reinforced{
	dir = 1
	},
/obj/effect/turf_decal/tile/neutral/half/contrasted{
	dir = 4
	},
/obj/machinery/light,
/obj/item/storage/box/syringes,
/turf/open/floor/plasteel/grid/steel,
/area/ruin/unpowered)
"n" = (
/obj/effect/turf_decal/delivery,
/obj/structure/frame/computer{
	dir = 4
	},
/turf/open/floor/plasteel/grid/steel,
/area/ruin/unpowered)
"o" = (
/obj/effect/turf_decal/stripes/line{
	dir = 1
	},
/obj/item/storage/belt/medical{
	pixel_y = 2
	},
/obj/effect/turf_decal/tile/neutral/half/contrasted{
	dir = 4
	},
/obj/structure/closet/secure_closet/medical3{
	req_access = null;
	req_access_txt = "5"
	},
/turf/open/floor/plasteel,
/area/ruin/unpowered)
"q" = (
/obj/effect/spawner/structure/window/reinforced/tinted,
/turf/open/floor/plating,
/area/ruin/unpowered)
"r" = (
/turf/open/floor/plasteel/grid/steel,
/area/ruin/unpowered)
"w" = (
/obj/effect/abstract/open_area_marker{
	dir = 1
	},
/turf/open/floor/plasteel/white,
/area/ruin/unpowered)
"x" = (
/obj/structure/table/glass,
/obj/item/storage/box/beakers{
	pixel_x = 3;
	pixel_y = 3
	},
/obj/structure/window/reinforced{
	dir = 1
	},
/obj/effect/turf_decal/tile/neutral/half/contrasted{
	dir = 4
	},
/obj/structure/window/reinforced{
	dir = 4
	},
/turf/open/floor/plasteel,
/area/ruin/unpowered)
"A" = (
/turf/open/floor/plasteel/white,
/area/ruin/unpowered)
"F" = (
/obj/effect/turf_decal/tile/neutral/half/contrasted,
/obj/effect/turf_decal/stripes/line{
	dir = 4
	},
/obj/machinery/door/window/westleft{
	dir = 4;
	name = "First-Aid Supplies";
	req_access_txt = "5"
	},
/obj/structure/table/glass,
/obj/item/reagent_containers/spray/cleaner{
	pixel_x = -3;
	pixel_y = 2
	},
/obj/item/storage/belt/medical,
/obj/item/clothing/neck/stethoscope,
/obj/item/storage/belt/medical,
/obj/item/clothing/neck/stethoscope,
/obj/item/clothing/glasses/hud/health,
/obj/item/clothing/glasses/hud/health,
/obj/structure/window/reinforced{
	layer = 2.9
	},
/obj/effect/loot_jobscale/medical/first_aid_kit,
/turf/open/floor/plasteel{
	heat_capacity = 1e+006
	},
/area/ruin/unpowered)
"G" = (
/turf/closed/wall,
/area/ruin/unpowered)
"H" = (
/obj/effect/turf_decal/tile/blue{
	dir = 1
	},
/turf/open/floor/plasteel/white,
/area/ruin/unpowered)
"J" = (
/obj/machinery/door/airlock/medical{
	name = "Medbay Storage";
	req_access_txt = "5"
	},
/obj/machinery/door/firedoor,
/obj/effect/turf_decal/delivery,
/obj/effect/turf_decal/stripes/line,
/obj/effect/turf_decal/stripes/line{
	dir = 1
	},
/obj/effect/abstract/doorway_marker{
	dir = 1
	},
/turf/open/floor/plasteel/grid/steel,
/area/ruin/unpowered)
"K" = (
/obj/effect/abstract/open_area_marker,
/turf/open/floor/plasteel/white,
/area/ruin/unpowered)
"L" = (
/obj/effect/turf_decal/tile/neutral/half/contrasted,
/obj/machinery/vending/wardrobe/medi_wardrobe,
/turf/open/floor/plasteel{
	heat_capacity = 1e+006
	},
/area/ruin/unpowered)
"O" = (
/obj/effect/turf_decal/stripes/line{
	dir = 1
	},
/obj/effect/turf_decal/tile/neutral/half/contrasted{
	dir = 4
	},
/obj/structure/closet/secure_closet/medical3{
	req_access = null;
	req_access_txt = "5"
	},
/obj/structure/extinguisher_cabinet{
	pixel_y = -29
	},
/turf/open/floor/plasteel,
/area/ruin/unpowered)
"P" = (
/obj/effect/turf_decal/tile/blue/half/contrasted{
	dir = 1
	},
/turf/open/floor/plasteel/white,
/area/ruin/unpowered)
"Q" = (
/obj/effect/turf_decal/tile/neutral/half/contrasted{
	dir = 8
	},
/obj/machinery/vending/medical,
/obj/effect/turf_decal/stripes/line,
/turf/open/floor/plasteel,
/area/ruin/unpowered)
"U" = (
/obj/machinery/light{
	dir = 8
	},
/obj/effect/turf_decal/tile/blue{
	dir = 8
	},
/turf/open/floor/plasteel/white,
/area/ruin/unpowered)
"Y" = (
/obj/structure/table/glass,
/obj/machinery/door/window/eastleft{
	dir = 1;
	name = "First-Aid Supplies";
	red_alert_access = 1;
	req_access_txt = "5"
	},
/obj/effect/turf_decal/tile/neutral/half/contrasted{
	dir = 4
	},
/obj/effect/loot_jobscale/medical/medkits{
	pixel_x = -6;
	pixel_y = 2
	},
/obj/machinery/camera/autoname{
	dir = 10;
	network = list("ss13","medbay")
	},
/turf/open/floor/plasteel,
/area/ruin/unpowered)

(1,1,1) = {"
G
G
G
G
G
G
"}
(2,1,1) = {"
G
F
L
n
m
G
"}
(3,1,1) = {"
J
r
r
r
Y
G
"}
(4,1,1) = {"
G
b
r
j
x
G
"}
(5,1,1) = {"
G
Q
r
r
O
G
"}
(6,1,1) = {"
G
a
r
r
o
G
"}
(7,1,1) = {"
G
f
c
c
f
k
"}
(8,1,1) = {"
U
P
P
P
H
A
"}
(9,1,1) = {"
w
A
A
A
A
K
"}
(10,1,1) = {"
A
A
A
A
A
A
"}
(11,1,1) = {"
i
q
g
q
G
G
"}
