//MAP CONVERTED BY dmm2tgm.py THIS HEADER COMMENT PREVENTS RECONVERSION, DO NOT REMOVE
"a" = (
/turf/closed/wall/r_wall,
/area/ruin/unpowered)
"b" = (
/obj/effect/turf_decal/tile/brown/fourcorners/contrasted,
/obj/effect/abstract/open_area_marker,
/turf/open/floor/plasteel,
/area/ruin/unpowered)
"d" = (
/obj/machinery/door/airlock/vault{
	name = "Vault Door";
	req_access_txt = "53"
	},
/obj/structure/sign/warning/electricshock{
	pixel_x = -32
	},
/obj/structure/sign/warning/securearea{
	pixel_x = 32
	},
/obj/structure/cable/yellow{
	icon_state = "1-2"
	},
/obj/effect/mapping_helpers/airlock/locked,
/obj/effect/mapping_helpers/airlock/cyclelink_helper{
	dir = 1
	},
/obj/machinery/door/firedoor,
/obj/machinery/atmospherics/pipe/simple/supply/hidden/layer2{
	dir = 1
	},
/obj/machinery/atmospherics/pipe/simple/scrubbers/hidden/layer4{
	dir = 1
	},
/turf/open/floor/plasteel,
/area/ruin/unpowered)
"e" = (
/obj/structure/filingcabinet,
/obj/effect/turf_decal/tile/neutral/half/contrasted,
/turf/open/floor/plasteel/dark,
/area/ruin/unpowered)
"i" = (
/obj/effect/turf_decal/stripes/line{
	dir = 10
	},
/obj/effect/turf_decal/stripes/corner{
	dir = 4
	},
/turf/open/floor/engine,
/area/ruin/unpowered)
"l" = (
/obj/structure/table/reinforced,
/turf/open/floor/circuit/green{
	luminosity = 2
	},
/area/ruin/unpowered)
"m" = (
/obj/structure/closet/crate/goldcrate,
/obj/effect/turf_decal/delivery,
/obj/effect/turf_decal/tile/neutral/half/contrasted{
	dir = 1
	},
/turf/open/floor/plasteel/dark,
/area/ruin/unpowered)
"n" = (
/obj/machinery/holopad,
/obj/effect/turf_decal/stripes/line{
	dir = 1
	},
/obj/effect/turf_decal/stripes/line,
/obj/effect/turf_decal/box,
/turf/open/floor/engine,
/area/ruin/unpowered)
"o" = (
/obj/machinery/light{
	dir = 4
	},
/obj/item/radio/intercom{
	pixel_x = 33;
	pixel_y = -2
	},
/obj/structure/table/reinforced,
/obj/effect/turf_decal/tile/neutral/half/contrasted{
	dir = 1
	},
/turf/open/floor/plasteel/dark,
/area/ruin/unpowered)
"q" = (
/turf/open/floor/circuit/green{
	luminosity = 2
	},
/area/ruin/unpowered)
"r" = (
/obj/structure/table/reinforced,
/obj/item/paper_bin{
	pixel_x = 4;
	pixel_y = 5
	},
/obj/item/pen/fountain{
	pixel_x = 4;
	pixel_y = 7
	},
/obj/effect/turf_decal/tile/neutral/half/contrasted,
/turf/open/floor/plasteel/dark,
/area/ruin/unpowered)
"t" = (
/obj/effect/turf_decal/tile/neutral/half/contrasted{
	dir = 1
	},
/obj/effect/turf_decal/guideline/guideline_edge/brown{
	dir = 8
	},
/turf/open/floor/plasteel,
/area/ruin/unpowered)
"w" = (
/obj/effect/turf_decal/stripes/line{
	dir = 9
	},
/obj/effect/turf_decal/stripes/corner,
/turf/open/floor/engine,
/area/ruin/unpowered)
"x" = (
/obj/structure/safe,
/obj/item/stack/spacecash/c1000,
/obj/item/stack/spacecash/c1000,
/obj/item/stack/spacecash/c1000,
/obj/item/stack/spacecash/c1000,
/obj/item/stack/spacecash/c1000,
/obj/item/stack/spacecash/c500,
/obj/item/stack/spacecash/c500,
/obj/item/ammo_box/a357,
/obj/effect/turf_decal/tile/neutral/half/contrasted{
	dir = 1
	},
/obj/structure/extinguisher_cabinet{
	pixel_x = 28
	},
/obj/item/reagent_containers/food/snacks/grown/shell/gatfruit,
/turf/open/floor/plasteel/dark,
/area/ruin/unpowered)
"B" = (
/obj/structure/closet/crate/silvercrate,
/obj/effect/turf_decal/delivery,
/obj/effect/turf_decal/tile/neutral/half/contrasted,
/turf/open/floor/plasteel/dark,
/area/ruin/unpowered)
"C" = (
/obj/structure/table/reinforced,
/obj/effect/turf_decal/tile/neutral/half/contrasted{
	dir = 1
	},
/turf/open/floor/plasteel/dark,
/area/ruin/unpowered)
"D" = (
/turf/closed/wall,
/area/ruin/unpowered)
"F" = (
/obj/effect/turf_decal/stripes/line{
	dir = 6
	},
/obj/effect/turf_decal/stripes/corner{
	dir = 1
	},
/turf/open/floor/engine,
/area/ruin/unpowered)
"G" = (
/obj/effect/turf_decal/stripes/line{
	dir = 1
	},
/obj/effect/turf_decal/stripes/line,
/turf/open/floor/engine,
/area/ruin/unpowered)
"I" = (
/obj/effect/turf_decal/stripes/line{
	dir = 4
	},
/obj/effect/turf_decal/stripes/line{
	dir = 8
	},
/turf/open/floor/engine,
/area/ruin/unpowered)
"L" = (
/obj/effect/turf_decal/guideline/guideline_edge/brown{
	dir = 4
	},
/turf/open/floor/plasteel,
/area/ruin/unpowered)
"M" = (
/obj/effect/turf_decal/delivery,
/obj/structure/sign/warning/electricshock{
	pixel_y = 32
	},
/turf/open/floor/circuit/green{
	luminosity = 2
	},
/area/ruin/unpowered)
"N" = (
/turf/template_noop,
/area/template_noop)
"P" = (
/obj/effect/turf_decal/stripes/line{
	dir = 5
	},
/obj/effect/turf_decal/stripes/corner{
	dir = 8
	},
/turf/open/floor/engine,
/area/ruin/unpowered)
"S" = (
/obj/machinery/light{
	dir = 8
	},
/obj/machinery/camera/motion{
	c_tag = "vault";
	dir = 5;
	network = list("ss13","security","cargo");
	pixel_y = 8
	},
/obj/structure/table/reinforced,
/obj/item/reagent_containers/food/drinks/drinkingglass/shotglass{
	pixel_x = 5;
	pixel_y = 11
	},
/obj/item/reagent_containers/food/drinks/drinkingglass/shotglass{
	pixel_x = 9;
	pixel_y = 5
	},
/obj/item/reagent_containers/food/drinks/bottle/vodka/badminka{
	pixel_x = -7;
	pixel_y = 17
	},
/obj/effect/turf_decal/tile/neutral/half/contrasted,
/turf/open/floor/plasteel/dark,
/area/ruin/unpowered)
"W" = (
/obj/machinery/ore_silo,
/obj/effect/turf_decal/delivery,
/obj/structure/sign/warning/securearea{
	pixel_y = 33
	},
/turf/open/floor/circuit/green{
	luminosity = 2
	},
/area/ruin/unpowered)

(1,1,1) = {"
a
a
a
a
a
a
N
"}
(2,1,1) = {"
a
r
S
B
e
a
D
"}
(3,1,1) = {"
a
W
w
I
i
a
t
"}
(4,1,1) = {"
a
l
n
q
G
d
b
"}
(5,1,1) = {"
a
M
P
I
F
a
L
"}
(6,1,1) = {"
a
C
o
m
x
a
D
"}
(7,1,1) = {"
a
a
a
a
a
a
N
"}
