//MAP CONVERTED BY dmm2tgm.py THIS HEADER COMMENT PREVENTS RECONVERSION, DO NOT REMOVE
"c" = (
/turf/closed/wall,
/area/ruin/unpowered)
"d" = (
/obj/effect/turf_decal/tile/blue/half/contrasted{
	dir = 8
	},
/turf/open/floor/iron/white,
/area/ruin/unpowered)
"e" = (
/obj/machinery/door/airlock/medical/glass,
/turf/open/floor/iron/white,
/area/ruin/unpowered)
"j" = (
/obj/structure/window/reinforced{
	dir = 1
	},
/obj/effect/turf_decal/tile/blue/fourcorners/contrasted,
/turf/open/floor/iron/white,
/area/ruin/unpowered)
"l" = (
/obj/effect/turf_decal/tile/blue/opposingcorners,
/turf/open/floor/iron/white,
/area/ruin/unpowered)
"m" = (
/obj/structure/table/glass,
/obj/machinery/door/window{
	dir = 8
	},
/obj/item/storage/firstaid,
/obj/effect/turf_decal/tile/blue/fourcorners/contrasted,
/turf/open/floor/iron/white,
/area/ruin/unpowered)
"n" = (
/obj/structure/frame/machine,
/obj/effect/turf_decal/tile/blue/fourcorners/contrasted,
/turf/open/floor/iron/white,
/area/ruin/unpowered)
"r" = (
/obj/machinery/vending/wardrobe/medi_wardrobe,
/obj/effect/turf_decal/tile/blue/fourcorners/contrasted,
/turf/open/floor/iron/white,
/area/ruin/unpowered)
"w" = (
/obj/effect/turf_decal/tile/blue{
	dir = 8
	},
/turf/open/floor/iron/white,
/area/ruin/unpowered)
"x" = (
/obj/effect/abstract/doorway_marker,
/turf/open/floor/iron/white,
/area/ruin/unpowered)
"y" = (
/obj/structure/table/glass,
/obj/structure/window/reinforced{
	dir = 4
	},
/obj/effect/spawner/lootdrop/ruinloot/medical,
/obj/effect/turf_decal/tile/blue/fourcorners/contrasted,
/turf/open/floor/iron/white,
/area/ruin/unpowered)
"z" = (
/obj/machinery/vending/medical,
/obj/effect/turf_decal/tile/blue/fourcorners/contrasted,
/turf/open/floor/iron/white,
/area/ruin/unpowered)
"A" = (
/obj/structure/closet/secure_closet/medical3,
/obj/effect/turf_decal/tile/blue/fourcorners/contrasted,
/turf/open/floor/iron/white,
/area/ruin/unpowered)
"B" = (
/obj/structure/window/reinforced,
/obj/structure/closet/secure_closet/medical3,
/obj/effect/turf_decal/tile/blue/fourcorners/contrasted,
/turf/open/floor/iron/white,
/area/ruin/unpowered)
"D" = (
/obj/effect/turf_decal/tile/blue{
	dir = 1
	},
/turf/open/floor/iron/white,
/area/ruin/unpowered)
"E" = (
/obj/structure/table/glass,
/obj/structure/window/reinforced{
	dir = 8
	},
/obj/effect/spawner/lootdrop/ruinloot/medical,
/obj/effect/turf_decal/tile/blue/fourcorners/contrasted,
/turf/open/floor/iron/white,
/area/ruin/unpowered)
"H" = (
/obj/effect/turf_decal/tile/blue,
/turf/open/floor/iron/white,
/area/ruin/unpowered)
"K" = (
/obj/effect/abstract/open_area_marker{
	dir = 4
	},
/turf/open/floor/iron/white,
/area/ruin/unpowered)
"M" = (
/obj/effect/spawner/structure/window,
/turf/open/floor/plating,
/area/ruin/unpowered)
"Q" = (
/obj/structure/table/glass,
/obj/machinery/door/window{
	dir = 4
	},
/obj/effect/spawner/lootdrop/ruinloot/medical,
/obj/effect/spawner/lootdrop/ruinloot/medical,
/obj/effect/turf_decal/tile/blue/fourcorners/contrasted,
/turf/open/floor/iron/white,
/area/ruin/unpowered)
"V" = (
/obj/effect/abstract/open_area_marker{
	dir = 8
	},
/turf/open/floor/iron/white,
/area/ruin/unpowered)
"X" = (
/obj/structure/window/reinforced,
/obj/structure/frame/computer{
	dir = 4
	},
/obj/effect/turf_decal/tile/blue/fourcorners/contrasted,
/turf/open/floor/iron/white,
/area/ruin/unpowered)
"Z" = (
/turf/open/floor/iron/white,
/area/ruin/unpowered)

(1,1,1) = {"
c
Z
V
Z
c
c
c
c
c
c
c
c
c
"}
(2,1,1) = {"
c
Z
Z
H
c
r
z
X
y
Q
y
j
c
"}
(3,1,1) = {"
c
Z
Z
d
M
D
D
D
D
D
D
l
x
"}
(4,1,1) = {"
c
Z
Z
d
e
D
Z
Z
Z
Z
Z
H
c
"}
(5,1,1) = {"
c
Z
Z
d
M
D
Z
M
c
M
Z
H
c
"}
(6,1,1) = {"
c
Z
Z
d
e
D
Z
Z
Z
Z
Z
H
c
"}
(7,1,1) = {"
c
Z
Z
d
M
l
H
H
H
H
H
H
c
"}
(8,1,1) = {"
c
Z
Z
w
c
n
A
B
E
m
E
j
c
"}
(9,1,1) = {"
c
Z
K
Z
c
c
c
c
c
c
c
c
c
"}
