//MAP CONVERTED BY dmm2tgm.py THIS HEADER COMMENT PREVENTS RECONVERSION, DO NOT REMOVE
"c" = (
/obj/effect/turf_decal/stripes/corner{
	dir = 8
	},
/turf/open/floor/iron,
/area/ruin/unpowered)
"f" = (
/obj/machinery/portable_atmospherics/canister/plasma,
/obj/effect/turf_decal/bot,
/obj/machinery/light,
/turf/open/floor/iron,
/area/ruin/unpowered)
"g" = (
/obj/effect/decal/cleanable/dirt,
/obj/effect/turf_decal/stripes/line{
	dir = 4
	},
/turf/open/floor/iron,
/area/ruin/unpowered)
"h" = (
/obj/machinery/portable_atmospherics/canister/plasma,
/obj/effect/decal/cleanable/dirt,
/obj/effect/turf_decal/bot,
/obj/effect/decal/cleanable/glitter,
/turf/open/floor/iron,
/area/ruin/unpowered)
"j" = (
/obj/effect/turf_decal/stripes/line{
	dir = 8
	},
/turf/open/floor/iron,
/area/ruin/unpowered)
"m" = (
/obj/effect/decal/cleanable/dirt,
/obj/effect/turf_decal/delivery,
/turf/open/floor/iron,
/area/ruin/unpowered)
"n" = (
/obj/effect/turf_decal/stripes/line,
/obj/structure/table,
/obj/item/wrench,
/obj/item/analyzer,
/turf/open/floor/iron,
/area/ruin/unpowered)
"s" = (
/obj/effect/turf_decal/bot,
/obj/machinery/portable_atmospherics/pump{
	name = "Lil Pump"
	},
/turf/open/floor/iron,
/area/ruin/unpowered)
"u" = (
/obj/effect/decal/cleanable/dirt,
/obj/effect/turf_decal/bot,
/turf/open/floor/iron,
/area/ruin/unpowered)
"w" = (
/turf/open/floor/iron,
/area/ruin/unpowered)
"x" = (
/obj/machinery/portable_atmospherics/scrubber/huge,
/obj/effect/turf_decal/bot,
/turf/open/floor/iron,
/area/ruin/unpowered)
"y" = (
/obj/effect/abstract/doorway_marker{
	dir = 1
	},
/turf/open/floor/iron,
/area/ruin/unpowered)
"A" = (
/obj/machinery/portable_atmospherics/scrubber/huge,
/obj/effect/decal/cleanable/dirt,
/obj/effect/turf_decal/bot,
/turf/open/floor/iron,
/area/ruin/unpowered)
"B" = (
/obj/effect/turf_decal/stripes/line{
	dir = 4
	},
/turf/open/floor/iron,
/area/ruin/unpowered)
"G" = (
/obj/effect/turf_decal/bot,
/turf/open/floor/iron,
/area/ruin/unpowered)
"J" = (
/obj/machinery/portable_atmospherics/canister/oxygen,
/obj/effect/decal/cleanable/dirt,
/obj/effect/turf_decal/bot,
/obj/machinery/light,
/turf/open/floor/iron,
/area/ruin/unpowered)
"L" = (
/obj/effect/turf_decal/stripes/line,
/turf/open/floor/iron,
/area/ruin/unpowered)
"M" = (
/obj/effect/turf_decal/delivery,
/turf/open/floor/iron,
/area/ruin/unpowered)
"P" = (
/obj/effect/turf_decal/stripes/corner,
/turf/open/floor/iron,
/area/ruin/unpowered)
"S" = (
/obj/machinery/portable_atmospherics/canister/nitrous_oxide,
/obj/effect/decal/cleanable/dirt,
/obj/effect/turf_decal/bot,
/turf/open/floor/iron,
/area/ruin/unpowered)
"V" = (
/turf/closed/wall/r_wall,
/area/ruin/unpowered)
"X" = (
/obj/machinery/portable_atmospherics/canister/carbon_dioxide,
/obj/effect/turf_decal/bot,
/turf/open/floor/iron,
/area/ruin/unpowered)
"Y" = (
/obj/machinery/portable_atmospherics/canister/oxygen,
/obj/effect/turf_decal/bot,
/turf/open/floor/iron,
/area/ruin/unpowered)
"Z" = (
/obj/machinery/portable_atmospherics/canister/plasma,
/obj/effect/turf_decal/bot,
/turf/open/floor/iron,
/area/ruin/unpowered)

(1,1,1) = {"
V
V
V
V
V
V
V
V
V
"}
(2,1,1) = {"
V
n
M
s
X
G
Y
J
V
"}
(3,1,1) = {"
y
L
m
G
G
Y
G
u
V
"}
(4,1,1) = {"
V
c
j
j
j
j
j
j
V
"}
(5,1,1) = {"
V
w
w
w
w
w
w
w
V
"}
(6,1,1) = {"
V
P
g
B
B
B
g
g
V
"}
(7,1,1) = {"
V
L
m
x
G
G
h
h
V
"}
(8,1,1) = {"
V
L
M
A
S
Z
G
f
V
"}
(9,1,1) = {"
V
V
V
V
V
V
V
V
V
"}
