//MAP CONVERTED BY dmm2tgm.py THIS HEADER COMMENT PREVENTS RECONVERSION, DO NOT REMOVE
"aa" = (
/obj/effect/turf_decal/tile/blue/half/contrasted,
/turf/open/floor/iron/white,
/area/ruin/unpowered)
"af" = (
/obj/machinery/computer/scan_consolenew{
	dir = 1
	},
/obj/effect/turf_decal/tile/blue/fourcorners/contrasted,
/turf/open/floor/iron/white,
/area/ruin/unpowered)
"ag" = (
/obj/effect/spawner/lootdrop/ruinloot/security,
/turf/open/floor/iron/freezer,
/area/ruin/unpowered)
"ai" = (
/obj/structure/sink{
	dir = 4;
	pixel_x = 12
	},
/obj/effect/turf_decal/tile/blue/half/contrasted,
/turf/open/floor/iron/white,
/area/ruin/unpowered)
"al" = (
/obj/effect/turf_decal/tile/blue{
	dir = 8
	},
/turf/open/floor/iron/white,
/area/ruin/unpowered)
"ap" = (
/obj/structure/window/reinforced{
	dir = 1;
	pixel_y = 1
	},
/turf/open/floor/iron/freezer,
/area/ruin/unpowered)
"aq" = (
/turf/closed/wall,
/area/ruin/unpowered)
"au" = (
/obj/effect/turf_decal/tile/blue{
	dir = 4
	},
/turf/open/floor/iron/white,
/area/ruin/unpowered)
"av" = (
/obj/structure/table/glass,
/obj/effect/spawner/lootdrop/ruinloot/medical,
/obj/effect/turf_decal/tile/blue/fourcorners/contrasted,
/turf/open/floor/iron/white,
/area/ruin/unpowered)
"ax" = (
/obj/structure/reagent_dispensers/fueltank,
/obj/item/weldingtool,
/turf/open/floor/plating,
/area/ruin/unpowered)
"aB" = (
/obj/effect/turf_decal/tile/blue/half/contrasted{
	dir = 1
	},
/turf/open/floor/iron/white,
/area/ruin/unpowered)
"aD" = (
/turf/open/floor/iron/white,
/area/ruin/unpowered)
"aE" = (
/obj/structure/bed/roller,
/turf/open/floor/iron/freezer,
/area/ruin/unpowered)
"aF" = (
/obj/effect/abstract/doorway_marker,
/turf/open/floor/plating,
/area/ruin/unpowered)
"aH" = (
/obj/machinery/door/window/westleft{
	dir = 1;
	name = "Monkey Pen";
	pixel_y = 2
	},
/turf/open/floor/iron/freezer,
/area/ruin/unpowered)
"aM" = (
/obj/effect/spawner/structure/window/reinforced,
/turf/open/floor/plating,
/area/ruin/unpowered)
"aO" = (
/turf/open/floor/plating,
/area/ruin/unpowered)
"aP" = (
/obj/machinery/door/window/westright{
	dir = 1;
	name = "Monkey Pen";
	pixel_y = 2
	},
/turf/open/floor/iron/freezer,
/area/ruin/unpowered)
"aQ" = (
/obj/effect/abstract/doorway_marker{
	dir = 8
	},
/turf/open/floor/plating,
/area/ruin/unpowered)
"aT" = (
/obj/effect/turf_decal/tile/blue/half/contrasted{
	dir = 1
	},
/obj/effect/decal/cleanable/glass,
/turf/open/floor/iron/white,
/area/ruin/unpowered)
"aV" = (
/obj/machinery/dna_scannernew,
/obj/effect/turf_decal/tile/blue/fourcorners/contrasted,
/turf/open/floor/iron/white,
/area/ruin/unpowered)
"aW" = (
/obj/effect/turf_decal/tile/blue{
	dir = 4
	},
/obj/effect/decal/cleanable/blood/splatter,
/turf/open/floor/iron/white,
/area/ruin/unpowered)
"aX" = (
/turf/open/floor/iron/freezer,
/area/ruin/unpowered)
"jw" = (
/obj/effect/turf_decal/tile/blue/half/contrasted{
	dir = 4
	},
/turf/open/floor/iron/white,
/area/ruin/unpowered)
"nT" = (
/obj/effect/turf_decal/tile/blue/half/contrasted{
	dir = 8
	},
/turf/open/floor/iron/white,
/area/ruin/unpowered)
"oS" = (
/obj/structure/chair/office/light{
	dir = 1
	},
/obj/effect/turf_decal/tile/blue/anticorner/contrasted{
	dir = 1
	},
/turf/open/floor/iron/white,
/area/ruin/unpowered)
"qV" = (
/obj/effect/abstract/doorway_marker{
	dir = 1
	},
/turf/open/floor/iron/white,
/area/ruin/unpowered)
"zg" = (
/obj/structure/table/glass,
/obj/item/storage/box/disks{
	pixel_y = 5
	},
/obj/item/clothing/gloves/color/latex,
/obj/item/clothing/gloves/color/latex,
/obj/effect/turf_decal/tile/blue/fourcorners/contrasted,
/turf/open/floor/iron/white,
/area/ruin/unpowered)
"Br" = (
/obj/structure/table/glass,
/obj/item/storage/pill_bottle/mutadone{
	pixel_x = 5;
	pixel_y = 4
	},
/obj/item/flashlight/pen{
	pixel_x = 1;
	pixel_y = 1
	},
/obj/effect/turf_decal/tile/blue/fourcorners/contrasted,
/obj/item/reagent_containers/food/drinks/bottle/synthflesh{
	pixel_x = -3;
	pixel_y = 4;
	list_reagents = list(/datum/reagent/medicine/synthflesh = 25)
	},
/turf/open/floor/iron/white,
/area/ruin/unpowered)
"CF" = (
/obj/effect/turf_decal/tile/blue/anticorner/contrasted{
	dir = 1
	},
/turf/open/floor/iron/white,
/area/ruin/unpowered)
"En" = (
/obj/machinery/vending/medical,
/obj/effect/turf_decal/tile/blue/fourcorners/contrasted,
/turf/open/floor/iron/white,
/area/ruin/unpowered)
"JJ" = (
/obj/machinery/vending/wardrobe/gene_wardrobe,
/obj/effect/turf_decal/tile/blue/fourcorners/contrasted,
/turf/open/floor/iron/white,
/area/ruin/unpowered)
"LE" = (
/obj/effect/turf_decal/tile/blue{
	dir = 1
	},
/turf/open/floor/iron/white,
/area/ruin/unpowered)
"Vk" = (
/obj/structure/chair/office/light,
/obj/effect/turf_decal/tile/blue/anticorner/contrasted{
	dir = 8
	},
/turf/open/floor/iron/white,
/area/ruin/unpowered)
"Xt" = (
/obj/effect/turf_decal/tile/blue/half/contrasted{
	dir = 4
	},
/obj/effect/decal/cleanable/blood/drip,
/turf/open/floor/iron/white,
/area/ruin/unpowered)
"XW" = (
/obj/structure/rack,
/obj/item/storage/box/rxglasses{
	pixel_x = 3;
	pixel_y = 3
	},
/obj/item/storage/box/monkeycubes,
/obj/effect/spawner/lootdrop/ruinloot/medical,
/obj/effect/turf_decal/tile/blue/fourcorners/contrasted,
/turf/open/floor/iron/white,
/area/ruin/unpowered)
"Zk" = (
/obj/machinery/computer/scan_consolenew,
/obj/effect/turf_decal/tile/blue/fourcorners/contrasted,
/turf/open/floor/iron/white,
/area/ruin/unpowered)

(1,1,1) = {"
aq
aq
aM
aM
aq
aq
aQ
aq
aq
"}
(2,1,1) = {"
aq
av
Br
zg
av
aq
aO
aO
aq
"}
(3,1,1) = {"
aq
Zk
oS
Vk
af
aq
ax
aO
aF
"}
(4,1,1) = {"
aq
aV
Xt
nT
aV
aq
aq
aq
aq
"}
(5,1,1) = {"
aq
CF
LE
al
aB
aT
aE
aE
aq
"}
(6,1,1) = {"
aq
jw
au
au
au
aW
aH
ag
aq
"}
(7,1,1) = {"
qV
aD
al
al
al
aD
aP
aX
aq
"}
(8,1,1) = {"
aq
En
JJ
XW
ai
aa
ap
aX
aq
"}
(9,1,1) = {"
aq
aq
aM
aM
aq
aq
aq
aq
aq
"}
