//MAP CONVERTED BY dmm2tgm.py THIS HEADER COMMENT PREVENTS RECONVERSION, DO NOT REMOVE
"a" = (
/obj/item/cardboard_cutout/adaptive/chess/black/king,
/turf/open/floor/holofloor/dark,
/area/template_noop)
"b" = (
/obj/item/cardboard_cutout/adaptive/chess/king,
/turf/open/floor/holofloor{
	icon_state = "white"
	},
/area/template_noop)
"q" = (
/obj/item/cardboard_cutout/adaptive/chess/black/pawn,
/turf/open/floor/holofloor/dark,
/area/template_noop)
"t" = (
/obj/item/cardboard_cutout/adaptive/chess/black/queen,
/turf/open/floor/holofloor{
	icon_state = "white"
	},
/area/template_noop)
"w" = (
/obj/item/cardboard_cutout/adaptive/chess/black/rook,
/turf/open/floor/holofloor/dark,
/area/template_noop)
"z" = (
/obj/item/cardboard_cutout/adaptive/chess/rook,
/turf/open/floor/holofloor{
	icon_state = "white"
	},
/area/template_noop)
"A" = (
/obj/item/cardboard_cutout/adaptive/chess/black/rook,
/turf/open/floor/holofloor{
	icon_state = "white"
	},
/area/template_noop)
"J" = (
/obj/item/cardboard_cutout/adaptive/chess/pawn,
/turf/open/floor/holofloor{
	icon_state = "white"
	},
/area/template_noop)
"L" = (
/obj/item/cardboard_cutout/adaptive/chess/rook,
/turf/open/floor/holofloor/dark,
/area/template_noop)
"S" = (
/obj/item/cardboard_cutout/adaptive/chess/pawn,
/turf/open/floor/holofloor/dark,
/area/template_noop)
"T" = (
/obj/item/cardboard_cutout/adaptive/chess/queen,
/turf/open/floor/holofloor/dark,
/area/template_noop)
"W" = (
/obj/item/cardboard_cutout/adaptive/chess/black/pawn,
/turf/open/floor/holofloor{
	icon_state = "white"
	},
/area/template_noop)

(1,1,1) = {"
L
J
q
A
"}
(2,1,1) = {"
b
S
W
a
"}
(3,1,1) = {"
T
J
q
t
"}
(4,1,1) = {"
z
S
W
w
"}
