//MAP CONVERTED BY dmm2tgm.py THIS HEADER COMMENT PREVENTS RECONVERSION, DO NOT REMOVE
"bf" = (
/obj/effect/turf_decal/bot,
/obj/machinery/power/apc/auto_name/directional/west{
	pixel_x = -24;
	locked = 0
	},
/obj/structure/cable/yellow{
	icon_state = "0-4"
	},
/obj/effect/turf_decal/stripes/line{
	dir = 1
	},
/turf/open/floor/mineral/plastitanium,
/area/space)
"bY" = (
/turf/open/floor/mineral/plastitanium,
/area/space)
"cR" = (
/obj/machinery/computer/camera_advanced/syndie{
	dir = 1
	},
/turf/open/floor/mineral/plastitanium/red,
/area/space)
"dV" = (
/obj/effect/turf_decal/bot,
/turf/open/floor/mineral/plastitanium,
/area/space)
"eK" = (
/obj/machinery/atmospherics/components/unary/plasma_refiner{
	dir = 4
	},
/obj/machinery/light/small{
	dir = 8
	},
/turf/open/floor/plating,
/area/space)
"eN" = (
/turf/template_noop,
/area/template_noop)
"fd" = (
/obj/item/clothing/suit/space/syndicate/black/red,
/turf/open/floor/white,
/area/template_noop)
"fi" = (
/obj/item/gun/ballistic/automatic/pistol/suppressed,
/turf/open/floor/white,
/area/template_noop)
"gz" = (
/obj/effect/turf_decal/bot,
/obj/effect/turf_decal/stripes/line{
	dir = 1
	},
/turf/open/floor/mineral/plastitanium,
/area/space)
"hx" = (
/obj/effect/turf_decal/bot,
/obj/structure/closet/crate/secure/weapon{
	req_access_txt = "150"
	},
/turf/open/floor/mineral/plastitanium,
/area/space)
"hA" = (
/obj/structure/table/reinforced,
/obj/item/toy/cards/deck/syndicate,
/obj/item/melee/transforming/energy/sword{
	pixel_y = 14
	},
/obj/item/melee/transforming/energy/sword{
	pixel_y = 14;
	pixel_x = 16
	},
/obj/item/melee/transforming/energy/sword{
	pixel_y = 14;
	pixel_x = 8
	},
/turf/open/floor/mineral/plastitanium/red,
/area/space)
"hF" = (
/turf/open/floor/white,
/area/template_noop)
"iS" = (
/obj/item/ammo_box/magazine/smgm45,
/turf/open/floor/white,
/area/template_noop)
"jd" = (
/obj/machinery/computer/launchpad{
	dir = 4
	},
/turf/open/floor/mineral/plastitanium/red,
/area/space)
"jp" = (
/obj/effect/turf_decal/bot,
/obj/machinery/suit_storage_unit/syndicate{
	suit_type = /obj/item/clothing/suit/space/syndicate/black/red
	},
/turf/open/floor/mineral/plastitanium,
/area/space)
"jr" = (
/obj/item/melee/transforming/energy/sword{
	pixel_y = 14
	},
/obj/item/melee/transforming/energy/sword{
	pixel_y = 14;
	pixel_x = 8
	},
/obj/item/melee/transforming/energy/sword{
	pixel_y = 14;
	pixel_x = 16
	},
/turf/open/floor/white,
/area/template_noop)
"jA" = (
/obj/item/restraints/handcuffs,
/turf/open/floor/white,
/area/template_noop)
"kI" = (
/obj/item/clothing/glasses/sunglasses/advanced,
/turf/open/floor/white,
/area/template_noop)
"lh" = (
/obj/effect/turf_decal/stripes/corner{
	dir = 8
	},
/turf/open/floor/mineral/plastitanium,
/area/space)
"lG" = (
/obj/item/grenade/smokebomb,
/turf/open/floor/white,
/area/template_noop)
"mc" = (
/obj/item/soap/syndie,
/turf/open/floor/white,
/area/template_noop)
"nn" = (
/obj/machinery/atmospherics/pipe/manifold/purple/visible,
/obj/structure/closet/crate,
/obj/item/stack/sheet/iron{
	amount = 25
	},
/obj/item/stack/sheet/glass{
	amount = 10
	},
/obj/item/stack/sheet/mineral/copper{
	amount = 5
	},
/obj/effect/spawner/lootdrop/maintenance/two,
/obj/item/pickaxe/emergency,
/obj/item/stack/sheet/mineral/plasma/five,
/turf/open/floor/plating,
/area/space)
"pk" = (
/obj/structure/cable/yellow{
	icon_state = "1-8"
	},
/obj/effect/turf_decal/stripes/line{
	dir = 1
	},
/turf/open/floor/mineral/plastitanium,
/area/space)
"pr" = (
/obj/effect/turf_decal/bot,
/obj/effect/turf_decal/stripes/line,
/turf/open/floor/mineral/plastitanium,
/area/space)
"qb" = (
/obj/item/gun/ballistic/automatic/c20r,
/turf/open/floor/white,
/area/template_noop)
"rk" = (
/obj/machinery/atmospherics/pipe/manifold/purple/visible,
/obj/structure/closet/crate/hydroponics,
/turf/open/floor/plating,
/area/space)
"sl" = (
/obj/machinery/launchpad,
/turf/open/floor/mineral/plastitanium/red,
/area/space)
"vz" = (
/obj/effect/turf_decal/stripes/line{
	dir = 8
	},
/turf/open/floor/mineral/plastitanium,
/area/space)
"wM" = (
/obj/machinery/power/port_gen/pacman,
/obj/machinery/atmospherics/pipe/manifold/purple/visible,
/obj/structure/cable/yellow{
	icon_state = "0-2"
	},
/turf/open/floor/plating,
/area/space)
"xd" = (
/obj/machinery/computer/crew/syndie{
	dir = 1
	},
/turf/open/floor/mineral/plastitanium/red,
/area/space)
"xS" = (
/obj/item/stack/sheet/sandbags/five,
/turf/open/floor/white,
/area/template_noop)
"ya" = (
/obj/effect/turf_decal/bot,
/obj/structure/closet/crate/secure/gear{
	req_access_txt = "150"
	},
/turf/open/floor/mineral/plastitanium,
/area/space)
"yA" = (
/obj/item/ammo_box/magazine/m10mm,
/turf/open/floor/white,
/area/template_noop)
"zF" = (
/obj/item/reagent_containers/food/drinks/syndicatebeer{
	pixel_x = -8
	},
/obj/item/reagent_containers/food/drinks/syndicatebeer,
/obj/item/reagent_containers/food/drinks/syndicatebeer{
	pixel_x = 8
	},
/turf/open/floor/white,
/area/template_noop)
"Aa" = (
/obj/effect/turf_decal/stripes/corner,
/turf/open/floor/mineral/plastitanium,
/area/space)
"Ch" = (
/obj/effect/turf_decal/stripes/line{
	dir = 1
	},
/turf/open/floor/mineral/plastitanium,
/area/space)
"Ck" = (
/obj/item/clothing/mask/muzzle,
/turf/open/floor/white,
/area/template_noop)
"Fl" = (
/obj/effect/turf_decal/stripes/line{
	dir = 6
	},
/turf/open/floor/mineral/plastitanium,
/area/space)
"KI" = (
/obj/item/clothing/glasses/night,
/turf/open/floor/white,
/area/template_noop)
"Ls" = (
/obj/effect/turf_decal/stripes/line,
/obj/structure/chair/fancy/shuttle,
/obj/effect/mob_spawn/human/corpse/syndicate/commander,
/turf/open/floor/mineral/plastitanium,
/area/space)
"LG" = (
/obj/item/pizzabox/pineapple,
/turf/open/floor/white,
/area/template_noop)
"NA" = (
/obj/effect/turf_decal/bot,
/obj/effect/turf_decal/stripes/line,
/obj/machinery/modular_fabricator/autolathe/hacked,
/turf/open/floor/mineral/plastitanium,
/area/space)
"OQ" = (
/obj/effect/turf_decal/stripes/line{
	dir = 4
	},
/turf/open/floor/mineral/plastitanium,
/area/space)
"PP" = (
/obj/item/food/syndicake,
/turf/open/floor/white,
/area/template_noop)
"Qj" = (
/obj/machinery/shuttle/engine/plasma,
/turf/open/floor/plating,
/area/space)
"RO" = (
/obj/structure/table/reinforced,
/obj/item/storage/toolbox/syndicate,
/turf/open/floor/mineral/plastitanium/red,
/area/space)
"Tp" = (
/obj/machinery/computer/shuttle_flight/custom_shuttle/bluespace_pod/traitor{
	dir = 1;
	req_access = list(151)
	},
/turf/open/floor/mineral/plastitanium/red,
/area/space)
"Uo" = (
/obj/structure/cable/yellow{
	icon_state = "4-8"
	},
/obj/effect/turf_decal/stripes/line{
	dir = 1
	},
/turf/open/floor/mineral/plastitanium,
/area/space)
"UV" = (
/obj/effect/spawner/structure/window/plastitanium,
/turf/open/floor/plating,
/area/space)
"Wl" = (
/turf/closed/wall/mineral/plastitanium,
/area/space)
"Yb" = (
/obj/structure/fans/tiny,
/obj/effect/turf_decal/stripes/closeup{
	dir = 1
	},
/obj/machinery/door/airlock/centcom{
	name = "shuttle airlock";
	req_one_access_txt = "150"
	},
/turf/open/floor/mineral/plastitanium/red,
/area/space)
"YE" = (
/obj/machinery/atmospherics/components/unary/shuttle/heater,
/obj/effect/spawner/structure/window/plastitanium,
/turf/open/floor/plating,
/area/space)
"Zk" = (
/obj/machinery/portable_atmospherics/canister/plasma,
/obj/machinery/atmospherics/components/unary/portables_connector/visible{
	dir = 8
	},
/obj/machinery/light/small{
	dir = 4
	},
/turf/open/floor/plating,
/area/space)
"ZM" = (
/obj/effect/turf_decal/stripes/line{
	dir = 10
	},
/turf/open/floor/mineral/plastitanium,
/area/space)
"ZQ" = (
/obj/structure/chair/fancy/shuttle{
	dir = 8
	},
/obj/effect/mob_spawn/human/corpse/syndicate/operative,
/turf/open/floor/mineral/plastitanium/red,
/area/space)

(1,1,1) = {"
eN
Wl
Wl
Wl
Yb
UV
Wl
Wl
UV
Wl
eN
"}
(2,1,1) = {"
Wl
Wl
eK
bf
dV
pr
sl
jd
RO
UV
UV
"}
(3,1,1) = {"
Qj
YE
rk
Uo
bY
lh
vz
vz
ZM
xd
UV
"}
(4,1,1) = {"
Qj
YE
wM
pk
jp
ya
hx
bY
Ls
Tp
UV
"}
(5,1,1) = {"
Qj
YE
nn
Ch
bY
Aa
OQ
OQ
Fl
cR
UV
"}
(6,1,1) = {"
Wl
Wl
Zk
gz
dV
NA
ZQ
ZQ
hA
UV
UV
"}
(7,1,1) = {"
eN
Wl
Wl
Wl
Yb
UV
Wl
Wl
UV
Wl
eN
"}
(8,1,1) = {"
hF
hF
LG
zF
xS
kI
yA
yA
yA
yA
iS
"}
(9,1,1) = {"
hF
hF
hF
fd
PP
KI
fi
jA
Ck
lG
iS
"}
(10,1,1) = {"
hF
hF
hF
hF
mc
KI
fi
jr
hF
hF
qb
"}
(11,1,1) = {"
hF
hF
hF
hF
hF
hF
hF
hF
hF
hF
hF
"}
