//MAP CONVERTED BY dmm2tgm.py THIS HEADER COMMENT PREVENTS RECONVERSION, DO NOT REMOVE
"a" = (
/obj/effect/turf_decal/stripes/line{
	dir = 1
	},
/obj/machinery/light/small{
	dir = 8
	},
/obj/machinery/atmospherics/components/unary/plasma_refiner{
	dir = 4
	},
/turf/open/floor/plating,
/area/space)
"b" = (
/turf/template_noop,
/area/space)
"e" = (
/turf/closed/wall/mineral/plastitanium/nodiagonal,
/area/space)
"g" = (
/obj/structure/fans/tiny,
/obj/effect/turf_decal/stripes/line{
	dir = 4
	},
/obj/effect/turf_decal/stripes/line{
	dir = 8
	},
/obj/machinery/door/airlock/centcom{
	name = "Shuttle Airlock";
	req_access_txt = ""
	},
/turf/open/floor/mineral/plastitanium/red,
/area/space)
"h" = (
/obj/effect/turf_decal/stripes/line{
	dir = 1
	},
/obj/machinery/atmospherics/pipe/manifold/purple/visible{
	dir = 1
	},
/obj/machinery/power/port_gen/pacman,
/obj/structure/cable/yellow,
/turf/open/floor/plating,
/area/space)
"j" = (
/obj/effect/turf_decal/bot,
/obj/machinery/modular_fabricator/autolathe/hacked,
/turf/open/floor/mineral/plastitanium,
/area/space)
"k" = (
/obj/effect/turf_decal/stripes/corner{
	dir = 4
	},
/obj/structure/table/reinforced,
/obj/item/toy/nuke,
/obj/item/toy/cards/deck/syndicate,
/turf/open/floor/mineral/plastitanium,
/area/space)
"m" = (
/obj/effect/turf_decal/stripes/corner{
	dir = 1
	},
/obj/structure/table/reinforced,
/obj/item/storage/toolbox/syndicate,
/turf/open/floor/mineral/plastitanium,
/area/space)
"o" = (
/obj/structure/chair/fancy/shuttle{
	dir = 8
	},
/obj/effect/turf_decal/stripes/line{
	dir = 10
	},
/turf/open/floor/mineral/plastitanium/red,
/area/space)
"q" = (
/obj/structure/cable/yellow{
	icon_state = "1-2"
	},
/obj/structure/cable/yellow{
	icon_state = "1-8"
	},
/obj/structure/cable/yellow{
	icon_state = "1-4"
	},
/turf/open/floor/mineral/plastitanium,
/area/space)
"r" = (
/obj/effect/turf_decal/stripes/line{
	dir = 1
	},
/turf/open/floor/mineral/plastitanium,
/area/space)
"s" = (
/obj/structure/cable/yellow{
	icon_state = "2-8"
	},
/turf/open/floor/mineral/plastitanium,
/area/space)
"t" = (
/obj/effect/spawner/structure/window/plastitanium,
/turf/open/floor/plating,
/area/space)
"v" = (
/obj/effect/turf_decal/bot,
/obj/structure/closet/crate,
/obj/effect/spawner/lootdrop/maintenance,
/obj/structure/cable/yellow{
	icon_state = "1-2"
	},
/obj/item/stack/sheet/mineral/plasma/five,
/turf/open/floor/mineral/plastitanium,
/area/space)
"w" = (
/obj/effect/turf_decal/stripes/line{
	dir = 1
	},
/obj/machinery/atmospherics/pipe/manifold/purple/visible{
	dir = 1
	},
/obj/structure/cable/yellow,
/turf/open/floor/plating,
/area/space)
"x" = (
/obj/effect/turf_decal/bot,
/obj/structure/closet/crate,
/obj/effect/spawner/lootdrop/maintenance/three,
/obj/structure/cable/yellow{
	icon_state = "1-2"
	},
/obj/item/pickaxe/emergency,
/turf/open/floor/mineral/plastitanium,
/area/space)
"z" = (
/obj/machinery/computer/camera_advanced/syndie,
/turf/open/floor/mineral/plastitanium/red,
/area/space)
"A" = (
/obj/structure/cable/yellow{
	icon_state = "4-8"
	},
/turf/open/floor/mineral/plastitanium,
/area/space)
"C" = (
/obj/structure/chair/fancy/shuttle{
	dir = 4
	},
/obj/effect/turf_decal/stripes/line{
	dir = 5
	},
/obj/machinery/light/small{
	dir = 8
	},
/turf/open/floor/mineral/plastitanium/red,
/area/space)
"D" = (
/turf/open/floor/mineral/plastitanium,
/area/space)
"E" = (
/obj/machinery/shuttle/engine/plasma{
	dir = 1
	},
/turf/open/floor/plating,
/area/space)
"H" = (
/obj/structure/chair/fancy/shuttle{
	dir = 4
	},
/obj/effect/turf_decal/stripes/line{
	dir = 6
	},
/obj/machinery/power/apc/auto_name/directional/west{
	pixel_x = -24
	},
/obj/structure/cable/yellow{
	icon_state = "0-4"
	},
/turf/open/floor/mineral/plastitanium/red,
/area/space)
"I" = (
/obj/machinery/atmospherics/components/unary/shuttle/heater{
	dir = 1
	},
/obj/effect/spawner/structure/window/plastitanium,
/turf/open/floor/plating,
/area/space)
"K" = (
/obj/effect/turf_decal/stripes/line{
	dir = 1
	},
/obj/machinery/atmospherics/pipe/manifold/purple/visible{
	dir = 1
	},
/obj/structure/cable/yellow,
/mob/living/simple_animal/hostile/carp/cayenne,
/turf/open/floor/plating,
/area/space)
"L" = (
/obj/machinery/computer/crew/syndie,
/turf/open/floor/mineral/plastitanium/red,
/area/space)
"M" = (
/obj/structure/chair/fancy/shuttle{
	dir = 1
	},
/obj/effect/turf_decal/stripes/line{
	dir = 1
	},
/turf/open/floor/mineral/plastitanium,
/area/space)
"P" = (
/obj/effect/turf_decal/bot,
/turf/open/floor/mineral/plastitanium,
/area/space)
"Q" = (
/turf/closed/wall/mineral/plastitanium,
/area/space)
"T" = (
/obj/structure/cable/yellow{
	icon_state = "2-4"
	},
/turf/open/floor/mineral/plastitanium,
/area/space)
"U" = (
/obj/structure/chair/fancy/shuttle{
	dir = 8
	},
/obj/effect/turf_decal/stripes/line{
	dir = 9
	},
/obj/machinery/light/small{
	dir = 4
	},
/turf/open/floor/mineral/plastitanium/red,
/area/space)
"V" = (
/obj/structure/fans/tiny,
/obj/effect/turf_decal/stripes/line{
	dir = 8
	},
/obj/effect/turf_decal/stripes/line{
	dir = 4
	},
/obj/machinery/door/airlock/centcom{
	name = "Shuttle Airlock";
	req_access_txt = ""
	},
/obj/docking_port/mobile{
	dir = 8;
	dwidth = 4;
	height = 6;
	shuttle_object_type = /datum/orbital_object/shuttle/custom_shuttle;
	width = 10
	},
/turf/open/floor/mineral/plastitanium/red,
/area/space)
"W" = (
/obj/effect/turf_decal/stripes/line{
	dir = 1
	},
/obj/machinery/portable_atmospherics/canister/plasma,
/obj/machinery/atmospherics/components/unary/portables_connector/visible{
	dir = 8
	},
/obj/machinery/light/small{
	dir = 4
	},
/turf/open/floor/plating,
/area/space)
"Y" = (
/obj/machinery/computer/shuttle_flight{
	desc = "Occasionally used to call in a resupply shuttle if one is in range.";
	icon_keyboard = "syndie_key";
	icon_screen = "syndishuttle";
	light_color = "#FA8282";
	name = "syndicate cargo shuttle console";
	possible_destinations = "syndielavaland_cargo";
	req_access_txt = "150";
	shuttleId = "syndie_cargo"
	},
/turf/open/floor/mineral/plastitanium/red,
/area/space)
"Z" = (
/obj/effect/turf_decal/bot,
/obj/structure/closet/crate,
/obj/effect/spawner/lootdrop/maintenance/two,
/obj/item/clothing/glasses/sunglasses/advanced,
/obj/structure/cable/yellow{
	icon_state = "2-8"
	},
/turf/open/floor/mineral/plastitanium,
/area/space)

(1,1,1) = {"
b
Q
t
Q
Q
t
g
Q
Q
Q
b
"}
(2,1,1) = {"
t
t
k
C
H
j
P
P
a
e
e
"}
(3,1,1) = {"
t
z
r
D
A
D
D
T
K
I
E
"}
(4,1,1) = {"
t
Y
M
D
Z
v
x
q
h
I
E
"}
(5,1,1) = {"
t
L
r
D
D
D
D
s
w
I
E
"}
(6,1,1) = {"
t
t
m
U
o
P
P
P
W
e
e
"}
(7,1,1) = {"
b
Q
t
Q
Q
t
V
Q
Q
Q
b
"}
