//MAP CONVERTED BY dmm2tgm.py THIS HEADER COMMENT PREVENTS RECONVERSION, DO NOT REMOVE
"ae" = (
/obj/machinery/porta_turret/syndicate/pod{
	dir = 8;
	faction = list("pirate");
	name = "syndicate semi-auto swivel gun"
	},
/obj/effect/decal/cleanable/cobweb,
/obj/effect/turf_decal/stripes/line{
	dir = 6
	},
/turf/open/floor/wood,
/area/shuttle/pirate)
"aq" = (
/obj/structure/shuttle/engine/heater,
/obj/structure/window/reinforced/survival_pod{
	dir = 1
	},
/turf/open/floor/plating,
/area/shuttle/pirate)
"aP" = (
/obj/machinery/porta_turret/syndicate/pod{
	dir = 8;
	faction = list("pirate");
	name = "syndicate semi-auto swivel gun"
	},
/obj/effect/decal/cleanable/cobweb/cobweb2,
/obj/effect/turf_decal/stripes/line{
	dir = 9
	},
/turf/open/floor/wood,
/area/shuttle/pirate)
"aX" = (
/obj/structure/fans/tiny,
/obj/machinery/door/poddoor{
	id = "pirate_gun_port_port_bow";
	name = "port quarter gun port"
	},
/turf/open/floor/plating,
/area/shuttle/pirate)
"cl" = (
/obj/machinery/porta_turret/syndicate/pod{
	dir = 8;
	faction = list("pirate");
	name = "syndicate semi-auto swivel gun"
	},
/obj/effect/decal/cleanable/cobweb/cobweb2,
/obj/effect/turf_decal/stripes/line{
	dir = 10
	},
/turf/open/floor/wood,
/area/shuttle/pirate)
"cs" = (
/obj/structure/table/wood,
/obj/effect/decal/cleanable/dirt,
/obj/item/reagent_containers/food/condiment/milk{
	pixel_x = 6;
	pixel_y = 7
	},
/obj/item/trash/candle{
	pixel_y = 6;
	pixel_x = -6
	},
/obj/item/reagent_containers/food/condiment/milk,
/turf/open/floor/wood,
/area/shuttle/pirate)
"ep" = (
/obj/machinery/button/door{
	pixel_x = 25;
	name = "starboard bow gun port control";
	req_access_txt = "180";
	id = "pirate_gun_port_starboard_bow";
	pixel_y = 8
	},
/obj/effect/decal/cleanable/dirt,
/obj/machinery/loot_locator,
/turf/open/floor/wood,
/area/shuttle/pirate)
"eO" = (
/obj/effect/decal/cleanable/dirt,
/obj/machinery/porta_turret/syndicate/pod{
	dir = 8;
	faction = list("pirate");
	name = "syndicate semi-auto swivel gun"
	},
/obj/effect/decal/cleanable/cobweb/cobweb2,
/obj/effect/turf_decal/stripes/line{
	dir = 9
	},
/turf/open/floor/wood,
/area/shuttle/pirate)
"fX" = (
/obj/item/stack/sheet/wood{
	amount = 3
	},
/turf/open/floor/wood,
/area/shuttle/pirate)
"gb" = (
/obj/effect/decal/cleanable/dirt,
/obj/structure/chair/wood{
	dir = 4
	},
/turf/open/floor/wood,
/area/shuttle/pirate)
"gc" = (
/obj/effect/turf_decal/siding/wood{
	dir = 1;
	layer = 1
	},
/obj/effect/decal/cleanable/dirt,
/turf/open/floor/wood,
/area/shuttle/pirate)
"gz" = (
/turf/closed/wall/mineral/wood,
/area/shuttle/pirate)
"hK" = (
/obj/machinery/computer/shuttle_flight/pirate{
	req_access_txt = "180"
	},
/obj/effect/turf_decal/siding/wood{
	dir = 1;
	layer = 1
	},
/obj/effect/decal/cleanable/cobweb,
/turf/open/floor/wood,
/area/shuttle/pirate)
"iO" = (
/obj/machinery/piratepad,
/obj/effect/decal/cleanable/dirt,
/obj/item/coin/iron{
	pixel_y = 1;
	pixel_x = 6
	},
/obj/item/coin/titanium{
	pixel_x = 4;
	pixel_y = -8
	},
/obj/item/coin/uranium{
	pixel_x = -4;
	pixel_y = 4
	},
/obj/item/coin/gold{
	pixel_y = -6;
	pixel_x = -8
	},
/obj/item/coin,
/obj/item/coin/plasma{
	pixel_x = -5
	},
/turf/open/floor/wood,
/area/shuttle/pirate)
"ja" = (
/obj/machinery/door/airlock/wood,
/obj/effect/decal/cleanable/dirt,
/obj/structure/fans/tiny,
/obj/effect/decal/cleanable/cobweb,
/turf/open/floor/wood,
/area/shuttle/pirate)
"kp" = (
/obj/structure/grille/broken,
/turf/open/floor/plating,
/area/shuttle/pirate)
"kB" = (
/obj/effect/turf_decal/siding/wood{
	dir = 1;
	layer = 1
	},
/turf/open/floor/wood,
/area/shuttle/pirate)
"ms" = (
/obj/structure/table/wood,
/obj/item/reagent_containers/food/condiment/milk{
	pixel_y = 2;
	pixel_x = -7
	},
/obj/item/candle/infinite{
	pixel_x = 1;
	pixel_y = 10
	},
/obj/item/reagent_containers/food/condiment/soymilk{
	pixel_x = 10;
	pixel_y = 7
	},
/turf/open/floor/wood,
/area/shuttle/pirate)
"mu" = (
/obj/effect/decal/cleanable/dirt,
/obj/machinery/porta_turret/syndicate/pod{
	dir = 8;
	faction = list("pirate");
	name = "syndicate semi-auto swivel gun"
	},
/obj/effect/turf_decal/stripes/line{
	dir = 10
	},
/turf/open/floor/wood,
/area/shuttle/pirate)
"nu" = (
/obj/effect/decal/cleanable/dirt,
/obj/structure/chair/wood{
	dir = 4
	},
/obj/item/shard{
	pixel_x = 11;
	pixel_y = -9
	},
/turf/open/floor/wood,
/area/shuttle/pirate)
"oj" = (
/obj/machinery/porta_turret/syndicate/pod{
	dir = 8;
	faction = list("pirate");
	name = "syndicate semi-auto swivel gun"
	},
/obj/effect/turf_decal/stripes/line{
	dir = 8
	},
/turf/open/floor/wood,
/area/shuttle/pirate)
"pz" = (
/obj/machinery/porta_turret/syndicate/pod{
	dir = 8;
	faction = list("pirate");
	name = "syndicate semi-auto swivel gun"
	},
/obj/effect/decal/cleanable/robot_debris,
/obj/effect/turf_decal/stripes/line{
	dir = 6
	},
/turf/open/floor/wood,
/area/shuttle/pirate)
"pU" = (
/obj/effect/turf_decal/siding/wood{
	dir = 1;
	layer = 1
	},
/obj/effect/decal/cleanable/dirt,
/obj/effect/decal/cleanable/cobweb/cobweb2,
/obj/item/storage/toolbox/syndicate{
	pixel_x = 3;
	pixel_y = 7
	},
/obj/item/candle/infinite{
	pixel_x = -6;
	pixel_y = 1
	},
/obj/item/storage/wallet{
	pixel_x = 7
	},
/obj/structure/table/wood/fancy/black,
/turf/open/floor/wood,
/area/shuttle/pirate)
"qm" = (
/obj/machinery/door/poddoor{
	id = "pirate_gun_port_forward";
	name = "forward gun port"
	},
/obj/structure/fans/tiny,
/turf/open/floor/plating,
/area/shuttle/pirate)
"sc" = (
/obj/structure/fans/tiny,
/obj/machinery/door/poddoor{
	id = "pirate_gun_port_port_quarter";
	name = "port quarter gun port"
	},
/turf/open/floor/plating,
/area/shuttle/pirate)
"sh" = (
/obj/structure/barricade/wooden/crude,
/turf/closed/wall/mineral/wood,
/area/shuttle/pirate)
"sy" = (
/obj/effect/mob_spawn/human/pirate{
	dir = 4
	},
/turf/open/floor/wood,
/area/shuttle/pirate)
"tl" = (
/obj/effect/turf_decal/stripes/line,
/turf/open/floor/wood,
/area/shuttle/pirate)
"tm" = (
/turf/open/floor/plating,
/area/shuttle/pirate)
"tq" = (
/obj/item/chair/wood,
/obj/effect/mob_spawn/human/skeleton,
/turf/open/floor/wood,
/area/shuttle/pirate)
"tW" = (
/obj/machinery/button/door{
	name = "forward gun port control";
	req_access_txt = "180";
	id = "pirate_gun_port_forward";
	pixel_y = 25
	},
/obj/item/reagent_containers/food/condiment/milk{
	pixel_x = -3;
	pixel_y = 10
	},
/obj/item/reagent_containers/food/condiment/milk{
	pixel_x = -6;
	pixel_y = 2
	},
/obj/item/reagent_containers/food/condiment/milk{
	pixel_x = 7;
	pixel_y = 6
	},
/obj/item/reagent_containers/food/condiment/milk{
	pixel_y = 3
	},
/obj/item/reagent_containers/food/condiment/milk{
	pixel_y = 2;
	pixel_x = 6
	},
/obj/item/reagent_containers/food/condiment/milk{
	pixel_x = -4;
	pixel_y = 6
	},
/obj/item/reagent_containers/food/condiment/milk,
/obj/item/reagent_containers/food/condiment/milk,
/obj/item/reagent_containers/food/condiment/milk{
	pixel_x = 4;
	pixel_y = 6
	},
/obj/item/reagent_containers/food/condiment/milk{
	pixel_x = 6;
	pixel_y = 7
	},
/obj/structure/closet/crate/wooden,
/turf/open/floor/wood,
/area/shuttle/pirate)
"uK" = (
/obj/effect/mob_spawn/human/pirate{
	dir = 8
	},
/turf/open/floor/wood,
/area/shuttle/pirate)
"uN" = (
/obj/machinery/door/airlock/wood,
/obj/structure/fans/tiny,
/obj/effect/decal/cleanable/cobweb/cobweb2,
/obj/docking_port/mobile{
	dir = 8;
	dwidth = 11;
	height = 7;
	width = 25;
	id = "pirateship_1728";
	name = "1728 pirate ship"
	},
/turf/open/floor/wood,
/area/shuttle/pirate)
"uX" = (
/obj/effect/decal/cleanable/dirt,
/obj/machinery/power/apc{
	aidisabled = 1;
	dir = 1;
	name = "Pirate Corvette APC";
	req_access = null;
	pixel_x = -25;
	cell_type = /obj/item/stock_parts/cell/high/slime
	},
/turf/open/floor/wood,
/area/shuttle/pirate)
"vB" = (
/obj/effect/decal/cleanable/dirt,
/obj/effect/decal/cleanable/oil/slippery,
/turf/open/floor/wood,
/area/shuttle/pirate)
"vQ" = (
/obj/structure/railing{
	dir = 6
	},
/obj/effect/turf_decal/siding/wood{
	dir = 6
	},
/obj/effect/decal/cleanable/dirt,
/obj/structure/table/wood,
/obj/item/gun/ballistic/rifle/leveraction{
	pixel_y = 10
	},
/obj/item/gun/ballistic/rifle/boltaction{
	pixel_y = 5
	},
/obj/item/gun/ballistic/revolver/golden{
	pixel_y = -3
	},
/obj/item/candle/infinite{
	pixel_x = 7;
	pixel_y = -1
	},
/turf/open/floor/wood,
/area/shuttle/pirate)
"wC" = (
/obj/effect/turf_decal/siding/wood/corner{
	dir = 8
	},
/obj/effect/decal/cleanable/dirt,
/turf/open/floor/wood,
/area/shuttle/pirate)
"wH" = (
/obj/effect/decal/cleanable/dirt,
/obj/effect/decal/cleanable/shreds,
/turf/open/floor/wood,
/area/shuttle/pirate)
"xe" = (
/obj/machinery/porta_turret/syndicate/pod{
	dir = 8;
	faction = list("pirate");
	name = "syndicate semi-auto swivel gun"
	},
/obj/effect/turf_decal/stripes/line{
	dir = 10
	},
/obj/effect/decal/cleanable/robot_debris,
/turf/open/floor/wood,
/area/shuttle/pirate)
"xs" = (
/obj/effect/decal/cleanable/dirt,
/obj/machinery/porta_turret/syndicate/pod{
	dir = 8;
	faction = list("pirate");
	name = "syndicate semi-auto swivel gun"
	},
/obj/effect/turf_decal/stripes/line{
	dir = 5
	},
/turf/open/floor/wood,
/area/shuttle/pirate)
"yP" = (
/obj/machinery/shuttle_scrambler,
/obj/machinery/button/door{
	pixel_x = -25;
	name = "port bow gun port control";
	req_access_txt = "180";
	id = "pirate_gun_port_port_bow";
	pixel_y = 8
	},
/turf/open/floor/wood,
/area/shuttle/pirate)
"zw" = (
/obj/effect/decal/cleanable/dirt,
/obj/structure/reagent_dispensers/watertank,
/obj/item/mop{
	pixel_x = -6;
	pixel_y = 3
	},
/obj/item/reagent_containers/glass/bucket{
	pixel_x = 5;
	pixel_y = 4
	},
/turf/open/floor/wood,
/area/shuttle/pirate)
"zP" = (
/obj/machinery/vending/boozeomat/all_access{
	onstation = 0
	},
/turf/closed/wall/mineral/wood,
/area/shuttle/pirate)
"Aj" = (
/obj/structure/grille,
/turf/open/floor/plating,
/area/shuttle/pirate)
"As" = (
/obj/effect/decal/cleanable/dirt,
/obj/structure/table/wood,
/obj/machinery/recharger,
/obj/machinery/button/door{
	pixel_x = -25;
	name = "port quarter gun port control";
	req_access_txt = "180";
	id = "pirate_gun_port_port_quarter";
	pixel_y = -8
	},
/obj/item/candle/infinite{
	pixel_x = 9
	},
/obj/item/food/chococoin{
	pixel_y = 7;
	pixel_x = -3
	},
/obj/item/food/chococoin{
	pixel_x = -8;
	pixel_y = 3
	},
/obj/item/food/chococoin{
	pixel_x = -6;
	pixel_y = -4
	},
/turf/open/floor/wood,
/area/shuttle/pirate)
"AG" = (
/obj/machinery/computer/camera_advanced/syndie,
/turf/open/floor/wood,
/area/shuttle/pirate)
"AM" = (
/obj/effect/decal/cleanable/dirt,
/obj/structure/chair/wood{
	dir = 8
	},
/turf/open/floor/wood,
/area/shuttle/pirate)
"Bo" = (
/obj/effect/turf_decal/siding/wood/corner,
/obj/effect/decal/cleanable/dirt,
/turf/open/floor/wood,
/area/shuttle/pirate)
"Bx" = (
/obj/effect/decal/cleanable/dirt,
/obj/effect/turf_decal/stripes/line,
/obj/structure/closet/secure_closet/personal,
/turf/open/floor/wood,
/area/shuttle/pirate)
"BL" = (
/obj/effect/decal/cleanable/dirt,
/obj/machinery/turretid{
	icon_state = "control_kill";
	lethal = 1;
	locked = 0;
	req_access = null;
	req_access_txt = "180";
	pixel_x = 25
	},
/obj/item/shard{
	pixel_x = -2;
	pixel_y = -2
	},
/turf/open/floor/wood,
/area/shuttle/pirate)
"BW" = (
/obj/effect/decal/cleanable/dirt,
/obj/machinery/porta_turret/syndicate/pod{
	dir = 8;
	faction = list("pirate");
	name = "syndicate semi-auto swivel gun"
	},
/obj/effect/decal/cleanable/cobweb,
/obj/effect/decal/cleanable/oil,
/obj/effect/turf_decal/stripes/line{
	dir = 6
	},
/turf/open/floor/wood,
/area/shuttle/pirate)
"Cy" = (
/obj/effect/turf_decal/siding/wood,
/obj/machinery/button/door{
	pixel_x = -25;
	name = "port quarter gun port control";
	req_access_txt = "180";
	id = "pirate_gun_port_port_quarter";
	pixel_y = 8
	},
/turf/open/floor/wood,
/area/shuttle/pirate)
"CA" = (
/obj/machinery/porta_turret/syndicate/pod{
	dir = 8;
	faction = list("pirate");
	name = "syndicate semi-auto swivel gun"
	},
/obj/effect/decal/cleanable/oil,
/obj/effect/turf_decal/stripes/line{
	dir = 8
	},
/obj/effect/decal/cleanable/oil/slippery,
/turf/open/floor/wood,
/area/shuttle/pirate)
"CV" = (
/obj/structure/railing,
/obj/effect/turf_decal/siding/wood,
/obj/structure/closet/crate/secure/weapon{
	req_access_txt = "180";
	desc = "A secure ammo crate.";
	name = "ammo crate"
	},
/turf/open/floor/wood,
/area/shuttle/pirate)
"Dp" = (
/obj/effect/mob_spawn/human/pirate/captain{
	dir = 4
	},
/obj/effect/turf_decal/stripes/line,
/turf/open/floor/wood,
/area/shuttle/pirate)
"Dq" = (
/obj/effect/decal/cleanable/dirt,
/obj/item/storage/backpack/duffelbag/syndie/x4{
	pixel_y = 8
	},
/obj/item/storage/backpack/duffelbag/syndie/c4,
/obj/item/grenade/empgrenade{
	pixel_y = 10
	},
/obj/item/grenade/empgrenade{
	pixel_x = 8;
	pixel_y = 10
	},
/obj/item/grenade/smokebomb{
	pixel_x = -5
	},
/obj/item/grenade/smokebomb{
	pixel_x = 5
	},
/obj/structure/closet/crate/wooden,
/turf/open/floor/wood,
/area/shuttle/pirate)
"Dz" = (
/obj/effect/decal/cleanable/dirt,
/obj/item/candle/infinite{
	pixel_x = 9
	},
/obj/structure/table/wood,
/obj/effect/decal/cleanable/robot_debris/old,
/turf/open/floor/wood,
/area/shuttle/pirate)
"DE" = (
/obj/structure/fans/tiny,
/obj/machinery/door/poddoor{
	id = "pirate_gun_port_forward";
	name = "forward gun port"
	},
/turf/open/floor/plating,
/area/shuttle/pirate)
"En" = (
/turf/template_noop,
/area/template_noop)
"Gd" = (
/obj/effect/decal/cleanable/oil,
/turf/open/floor/wood,
/area/shuttle/pirate)
"HR" = (
/obj/item/stack/sheet/wood/five,
/turf/open/floor/wood,
/area/shuttle/pirate)
"Ii" = (
/obj/effect/decal/cleanable/dirt,
/obj/item/shard{
	pixel_x = 3;
	pixel_y = 2
	},
/obj/item/broken_bottle,
/turf/open/floor/wood,
/area/shuttle/pirate)
"Jl" = (
/obj/machinery/porta_turret/syndicate/pod{
	dir = 8;
	faction = list("pirate");
	name = "syndicate semi-auto swivel gun"
	},
/obj/effect/decal/cleanable/cobweb,
/obj/effect/decal/cleanable/robot_debris,
/obj/effect/turf_decal/stripes/line{
	dir = 5
	},
/turf/open/floor/wood,
/area/shuttle/pirate)
"JP" = (
/obj/effect/decal/cleanable/dirt,
/obj/machinery/porta_turret/syndicate/pod{
	dir = 8;
	faction = list("pirate");
	name = "syndicate semi-auto swivel gun"
	},
/obj/effect/turf_decal/stripes/line{
	dir = 4
	},
/turf/open/floor/wood,
/area/shuttle/pirate)
"KC" = (
/obj/effect/decal/cleanable/ash,
/turf/open/floor/wood,
/area/shuttle/pirate)
"Lj" = (
/obj/structure/fans/tiny,
/obj/machinery/door/poddoor{
	id = "pirate_gun_port_starboard_bow";
	name = "starboard bow gun port"
	},
/turf/open/floor/plating,
/area/shuttle/pirate)
"MV" = (
/turf/open/floor/wood,
/area/shuttle/pirate)
"Nd" = (
/obj/effect/decal/cleanable/dirt,
/obj/machinery/button/door{
	pixel_x = -25;
	name = "port bow gun port control";
	req_access_txt = "180";
	id = "pirate_gun_port_port_bow";
	pixel_y = -8
	},
/turf/open/floor/wood,
/area/shuttle/pirate)
"Rx" = (
/obj/effect/decal/cleanable/dirt,
/obj/machinery/porta_turret/syndicate/pod{
	dir = 8;
	faction = list("pirate");
	name = "syndicate semi-auto swivel gun"
	},
/obj/effect/turf_decal/stripes/line{
	dir = 4
	},
/obj/effect/decal/cleanable/robot_debris/old,
/turf/open/floor/wood,
/area/shuttle/pirate)
"RG" = (
/obj/structure/barricade/wooden,
/turf/closed/wall/mineral/wood,
/area/shuttle/pirate)
"RH" = (
/obj/item/shard{
	pixel_x = 11;
	pixel_y = -9
	},
/turf/open/floor/wood,
/area/shuttle/pirate)
"RP" = (
/turf/open/floor/plasteel/stairs{
	dir = 1
	},
/area/shuttle/pirate)
"Sc" = (
/obj/effect/decal/cleanable/dirt,
/obj/item/stack/sheet/wood,
/turf/open/floor/wood,
/area/shuttle/pirate)
"TO" = (
/obj/machinery/button/door{
	pixel_x = 25;
	name = "starboard quarter gun port control";
	req_access_txt = "180";
	id = "pirate_gun_port_starboard_quarter";
	pixel_y = -8
	},
/obj/effect/decal/cleanable/dirt,
/obj/structure/table/wood,
/obj/machinery/recharger,
/obj/item/candle/infinite{
	pixel_x = 7;
	pixel_y = 12
	},
/turf/open/floor/wood,
/area/shuttle/pirate)
"Uk" = (
/obj/machinery/button/door{
	pixel_x = 25;
	name = "starboard bow gun port control";
	req_access_txt = "180";
	id = "pirate_gun_port_starboard_bow";
	pixel_y = -8
	},
/obj/item/reagent_containers/food/drinks/bottle/rum{
	name = "Captain Pete's Private Reserve Cuban Spaced Rum";
	pixel_x = -6;
	pixel_y = 8
	},
/turf/open/floor/wood,
/area/shuttle/pirate)
"Un" = (
/obj/effect/decal/cleanable/dirt,
/obj/item/reagent_containers/food/drinks/bottle/rum{
	name = "Captain Pete's Private Reserve Cuban Spaced Rum";
	pixel_x = -6;
	pixel_y = 8
	},
/turf/open/floor/wood,
/area/shuttle/pirate)
"Vm" = (
/obj/effect/turf_decal/siding/wood,
/obj/machinery/button/door{
	pixel_x = 25;
	name = "starboard quarter gun port control";
	req_access_txt = "180";
	id = "pirate_gun_port_starboard_quarter";
	pixel_y = 8
	},
/turf/open/floor/wood,
/area/shuttle/pirate)
"Vr" = (
/obj/effect/turf_decal/siding/wood{
	dir = 1;
	layer = 1
	},
/obj/effect/decal/cleanable/dirt,
/obj/item/reagent_containers/food/drinks/drinkingglass/shotglass{
	pixel_x = 6;
	pixel_y = 12
	},
/obj/item/reagent_containers/food/drinks/bottle/rum{
	name = "Captain Pete's Private Reserve Cuban Spaced Rum";
	pixel_x = -6;
	pixel_y = 8;
	list_reagents = list(/datum/reagent/consumable/ethanol/rum = 5)
	},
/obj/item/storage/box/matches,
/obj/item/clothing/mask/cigarette/cigar,
/obj/structure/table/wood/fancy/black,
/turf/open/floor/wood,
/area/shuttle/pirate)
"VB" = (
/obj/structure/fans/tiny,
/obj/machinery/door/poddoor{
	id = "pirate_gun_port_starboard_quarter";
	name = "starboard quarter gun port"
	},
/turf/open/floor/plating,
/area/shuttle/pirate)
"Ws" = (
/obj/structure/table/wood,
/obj/item/melee/transforming/energy/sword/pirate{
	pixel_x = -1;
	pixel_y = 6
	},
/obj/item/melee/transforming/energy/sword/pirate{
	pixel_x = 6;
	pixel_y = 6
	},
/obj/item/melee/transforming/energy/sword/pirate{
	pixel_x = 13;
	pixel_y = 6
	},
/obj/item/candle/infinite{
	pixel_x = -7;
	pixel_y = 9
	},
/turf/open/floor/wood,
/area/shuttle/pirate)
"WA" = (
/obj/effect/decal/cleanable/dirt,
/obj/effect/decal/cleanable/ash,
/turf/open/floor/wood,
/area/shuttle/pirate)
"Xh" = (
/obj/structure/statue/bananium/clown,
/turf/open/floor/plating,
/area/shuttle/pirate)
"Ya" = (
/obj/machinery/computer/piratepad_control,
/turf/open/floor/wood,
/area/shuttle/pirate)
"Yj" = (
/obj/structure/shuttle/engine/propulsion/right,
/turf/open/floor/plating,
/area/shuttle/pirate)
"YX" = (
/obj/effect/decal/cleanable/dirt,
/turf/open/floor/wood,
/area/shuttle/pirate)
"ZL" = (
/obj/structure/railing{
	dir = 10
	},
/obj/effect/turf_decal/siding/wood{
	dir = 10
	},
/obj/item/gun/ballistic/shotgun/riot{
	pixel_y = 4
	},
/obj/structure/table/wood,
/obj/item/gun/ballistic/shotgun/doublebarrel/improvised{
	pixel_y = 10
	},
/obj/item/gun/ballistic/shotgun/doublebarrel/hook{
	pixel_y = -3
	},
/obj/item/candle/infinite{
	pixel_y = -2
	},
/turf/open/floor/wood,
/area/shuttle/pirate)
"ZO" = (
/obj/effect/decal/cleanable/dirt,
/turf/open/floor/plasteel/stairs{
	dir = 1
	},
/area/shuttle/pirate)

(1,1,1) = {"
En
En
En
En
En
En
En
Aj
gz
aX
aX
aX
gz
ja
RG
sc
sc
sc
gz
sh
sh
gz
gz
gz
tm
"}
(2,1,1) = {"
En
En
En
En
gz
gz
RG
sh
gz
Jl
JP
BW
yP
YX
As
xs
Rx
pz
Cy
RP
gc
uX
zP
aq
Yj
"}
(3,1,1) = {"
En
En
En
kp
qm
ae
zw
sy
Nd
RH
WA
YX
HR
vB
Un
WA
nu
gb
wC
ZL
Vr
YX
Dp
aq
Yj
"}
(4,1,1) = {"
Xh
gz
gz
RG
gz
tW
YX
YX
MV
Dq
Ws
Ya
MV
iO
YX
AG
ms
cs
YX
CV
hK
YX
tl
aq
Yj
"}
(5,1,1) = {"
En
En
En
kp
DE
cl
Dz
uK
Uk
Sc
Gd
wH
Ii
YX
KC
fX
tq
AM
Bo
vQ
pU
MV
Bx
aq
Yj
"}
(6,1,1) = {"
En
En
En
En
gz
sh
gz
gz
gz
aP
oj
mu
ep
YX
TO
eO
CA
xe
Vm
ZO
kB
BL
sh
aq
Yj
"}
(7,1,1) = {"
En
En
En
En
En
En
En
Aj
gz
Lj
Lj
Lj
sh
uN
gz
VB
VB
VB
gz
RG
gz
gz
gz
gz
tm
"}
