//MAP CONVERTED BY dmm2tgm.py THIS HEADER COMMENT PREVENTS RECONVERSION, DO NOT REMOVE
"a" = (
/obj/item/cardboard_cutout/adaptive/chess/black/bishop,
/turf/open/floor/holofloor{
	icon_state = "white"
	},
/area/space)
"i" = (
/obj/item/cardboard_cutout/adaptive/chess/black/king,
/turf/open/floor/holofloor{
	icon_state = "white"
	},
/area/space)
"k" = (
/obj/item/cardboard_cutout/adaptive/chess/bishop,
/turf/open/floor/holofloor/dark,
/area/space)
"l" = (
/obj/item/cardboard_cutout/adaptive/chess/pawn,
/turf/open/floor/holofloor{
	icon_state = "white"
	},
/area/space)
"m" = (
/obj/item/cardboard_cutout/adaptive/chess/black/rook,
/turf/open/floor/holofloor/dark,
/area/space)
"n" = (
/turf/open/floor/holofloor{
	icon_state = "white"
	},
/area/space)
"u" = (
/obj/item/cardboard_cutout/adaptive/chess/black/pawn,
/turf/open/floor/holofloor/dark,
/area/space)
"x" = (
/obj/item/cardboard_cutout/adaptive/chess/rook,
/turf/open/floor/holofloor{
	icon_state = "white"
	},
/area/space)
"F" = (
/obj/item/cardboard_cutout/adaptive/chess/king,
/turf/open/floor/holofloor/dark,
/area/space)
"L" = (
/turf/open/floor/holofloor/dark,
/area/space)
"M" = (
/obj/item/cardboard_cutout/adaptive/chess/black/knight,
/turf/open/floor/holofloor/dark,
/area/space)
"X" = (
/obj/item/cardboard_cutout/adaptive/chess/knight,
/turf/open/floor/holofloor{
	icon_state = "white"
	},
/area/space)

(1,1,1) = {"
x
k
X
F
"}
(2,1,1) = {"
L
n
L
l
"}
(3,1,1) = {"
n
L
n
L
"}
(4,1,1) = {"
u
n
L
n
"}
(5,1,1) = {"
i
M
a
m
"}
