//MAP CONVERTED BY dmm2tgm.py THIS HEADER COMMENT PREVENTS RECONVERSION, DO NOT REMOVE
"a" = (
/obj/item/cardboard_cutout/adaptive/chess/king,
/turf/open/floor/holofloor{
	icon_state = "white"
	},
/area/template_noop)
"b" = (
/obj/item/cardboard_cutout/adaptive/chess/rook,
/turf/open/floor/holofloor/dark,
/area/template_noop)
"e" = (
/obj/item/cardboard_cutout/adaptive/chess/black/queen,
/turf/open/floor/holofloor/dark,
/area/template_noop)
"j" = (
/obj/item/cardboard_cutout/adaptive/chess/black/pawn,
/turf/open/floor/holofloor{
	icon_state = "white"
	},
/area/template_noop)
"o" = (
/obj/item/cardboard_cutout/adaptive/chess/black/king,
/turf/open/floor/holofloor{
	icon_state = "white"
	},
/area/template_noop)
"p" = (
/obj/item/cardboard_cutout/adaptive/chess/queen,
/turf/open/floor/holofloor/dark,
/area/template_noop)
"q" = (
/obj/item/cardboard_cutout/adaptive/chess/pawn,
/turf/open/floor/holofloor/dark,
/area/template_noop)
"u" = (
/obj/item/cardboard_cutout/adaptive/chess/pawn,
/turf/open/floor/holofloor{
	icon_state = "white"
	},
/area/template_noop)
"w" = (
/turf/open/floor/holofloor/dark,
/area/template_noop)
"z" = (
/obj/item/cardboard_cutout/adaptive/chess/rook,
/turf/open/floor/holofloor{
	icon_state = "white"
	},
/area/template_noop)
"I" = (
/turf/open/floor/holofloor{
	icon_state = "white"
	},
/area/template_noop)
"O" = (
/obj/item/cardboard_cutout/adaptive/chess/black/rook,
/turf/open/floor/holofloor/dark,
/area/template_noop)
"P" = (
/obj/item/cardboard_cutout/adaptive/chess/black/pawn,
/turf/open/floor/holofloor/dark,
/area/template_noop)
"W" = (
/obj/item/cardboard_cutout/adaptive/chess/black/rook,
/turf/open/floor/holofloor{
	icon_state = "white"
	},
/area/template_noop)

(1,1,1) = {"
z
p
a
b
"}
(2,1,1) = {"
q
u
q
u
"}
(3,1,1) = {"
I
w
I
w
"}
(4,1,1) = {"
P
j
P
j
"}
(5,1,1) = {"
W
e
o
O
"}
