//MAP CONVERTED BY dmm2tgm.py THIS HEADER COMMENT PREVENTS RECONVERSION, DO NOT REMOVE
"a" = (
/turf/open/floor/holofloor/dark,
/area/template_noop)
"j" = (
/obj/item/cardboard_cutout/adaptive/chess/bishop,
/turf/open/floor/holofloor/dark,
/area/template_noop)
"k" = (
/obj/item/cardboard_cutout/adaptive/chess/knight,
/turf/open/floor/holofloor{
	icon_state = "white"
	},
/area/template_noop)
"s" = (
/obj/item/cardboard_cutout/adaptive/chess/black/rook,
/turf/open/floor/holofloor/dark,
/area/template_noop)
"t" = (
/obj/item/cardboard_cutout/adaptive/chess/black/knight,
/turf/open/floor/holofloor/dark,
/area/template_noop)
"v" = (
/turf/open/floor/holofloor{
	icon_state = "white"
	},
/area/template_noop)
"w" = (
/obj/item/cardboard_cutout/adaptive/chess/pawn,
/turf/open/floor/holofloor{
	icon_state = "white"
	},
/area/template_noop)
"B" = (
/obj/item/cardboard_cutout/adaptive/chess/king,
/turf/open/floor/holofloor/dark,
/area/template_noop)
"E" = (
/obj/item/cardboard_cutout/adaptive/chess/black/bishop,
/turf/open/floor/holofloor{
	icon_state = "white"
	},
/area/template_noop)
"F" = (
/obj/item/cardboard_cutout/adaptive/chess/rook,
/turf/open/floor/holofloor{
	icon_state = "white"
	},
/area/template_noop)
"H" = (
/obj/item/cardboard_cutout/adaptive/chess/black/king,
/turf/open/floor/holofloor{
	icon_state = "white"
	},
/area/template_noop)
"R" = (
/obj/item/cardboard_cutout/adaptive/chess/black/pawn,
/turf/open/floor/holofloor/dark,
/area/template_noop)

(1,1,1) = {"
F
j
k
B
"}
(2,1,1) = {"
a
v
a
w
"}
(3,1,1) = {"
v
a
v
a
"}
(4,1,1) = {"
R
v
a
v
"}
(5,1,1) = {"
H
t
E
s
"}
