//MAP CONVERTED BY dmm2tgm.py THIS HEADER COMMENT PREVENTS RECONVERSION, DO NOT REMOVE
"c" = (
/obj/machinery/button/door{
	id = "sciencecargo";
	name = "Cargo Blast Door Toggle";
	pixel_x = -24
	},
/obj/structure/table/reinforced,
/obj/machinery/light{
	dir = 8;
	light_color = "#e8eaff"
	},
/obj/item/storage/toolbox/mechanical,
/obj/item/clothing/glasses/science,
/turf/open/floor/mineral/titanium/purple,
/area/shuttle/science)
"d" = (
/obj/effect/spawner/structure/window/shuttle,
/turf/open/floor/plating,
/area/shuttle/science)
"f" = (
/obj/machinery/atmospherics/pipe/simple/purple/visible{
	dir = 10
	},
/turf/open/floor/mineral/titanium/white,
/area/shuttle/science)
"g" = (
/obj/machinery/computer/shuttle_flight/science,
/turf/open/floor/mineral/titanium/white,
/area/shuttle/science)
"h" = (
/obj/structure/closet/crate/science,
/obj/item/circuitboard/computer/shuttle/science_shuttle,
/obj/item/stack/sheet/glass,
/obj/item/stack/sheet/glass,
/obj/item/stack/cable_coil/orange,
/obj/item/storage/toolbox/electrical,
/obj/effect/turf_decal/box,
/obj/item/pickaxe/emergency,
/obj/machinery/light{
	dir = 8;
	light_color = "#e8eaff"
	},
/turf/open/floor/mineral/titanium/purple,
/area/shuttle/science)
"m" = (
/obj/machinery/shuttle/engine/plasma{
	dir = 1
	},
/obj/structure/window/reinforced/survival_pod{
	dir = 1
	},
/turf/open/floor/plating,
/area/shuttle/science)
"n" = (
/obj/structure/table/reinforced,
/obj/machinery/light{
	dir = 4
	},
/obj/item/toy/plush/moth/random,
/turf/open/floor/mineral/titanium/purple,
/area/shuttle/science)
"o" = (
/obj/effect/turf_decal/box,
/obj/structure/tank_dispenser/oxygen,
/turf/open/floor/mineral/titanium/purple,
/area/shuttle/science)
"r" = (
/obj/machinery/door/airlock/titanium,
/obj/docking_port/mobile{
	dir = 8;
	dwidth = 6;
	height = 6;
	id = "science";
	name = "science shuttle";
	port_direction = 4;
	width = 9
	},
/obj/structure/cable/yellow{
	icon_state = "4-8"
	},
/obj/structure/fans/tiny,
/turf/open/floor/mineral/titanium/white,
/area/shuttle/science)
"s" = (
/obj/structure/cable/yellow,
/obj/machinery/power/apc/auto_name/east,
/turf/open/floor/mineral/titanium/purple,
/area/shuttle/science)
"t" = (
/turf/closed/wall/mineral/titanium/nodiagonal,
/area/shuttle/science)
"u" = (
/obj/effect/turf_decal/box,
/obj/machinery/portable_atmospherics/canister/air,
/turf/open/floor/mineral/titanium/purple,
/area/shuttle/science)
"v" = (
/obj/effect/turf_decal/box,
/obj/machinery/portable_atmospherics/canister/plasma,
/obj/machinery/atmospherics/components/unary/portables_connector/visible{
	dir = 1
	},
/obj/effect/mapping_helpers/atmos_auto_connect,
/turf/open/floor/mineral/titanium/purple,
/area/shuttle/science)
"x" = (
/obj/structure/cable/yellow{
	icon_state = "2-4"
	},
/turf/open/floor/mineral/titanium/white,
/area/shuttle/science)
"y" = (
/turf/closed/wall/mineral/titanium,
/area/shuttle/science)
"A" = (
/obj/machinery/modular_computer/console/preset/research,
/turf/open/floor/mineral/titanium/white,
/area/shuttle/science)
"H" = (
/obj/machinery/door/poddoor{
	id = "sciencecargo"
	},
/obj/structure/fans/tiny,
/turf/open/floor/mineral/titanium/white,
/area/shuttle/science)
"J" = (
/obj/machinery/atmospherics/components/unary/shuttle/heater{
	dir = 1
	},
/turf/open/floor/plating,
/area/shuttle/science)
"N" = (
/turf/open/floor/mineral/titanium/purple,
/area/shuttle/science)
"O" = (
/obj/machinery/atmospherics/pipe/manifold/purple/visible{
	dir = 1
	},
/turf/open/floor/mineral/titanium/white,
/area/shuttle/science)
"Q" = (
/obj/structure/chair/fancy/shuttle{
	dir = 1
	},
/turf/open/floor/mineral/titanium/white,
/area/shuttle/science)
"S" = (
/turf/open/floor/mineral/titanium/white,
/area/shuttle/science)
"T" = (
/obj/machinery/door/airlock/titanium/glass,
/turf/open/floor/mineral/titanium/white,
/area/shuttle/science)
"X" = (
/obj/machinery/atmospherics/pipe/simple/purple/visible{
	dir = 6
	},
/turf/open/floor/mineral/titanium/white,
/area/shuttle/science)

(1,1,1) = {"
y
y
y
y
y
y
y
y
y
"}
(2,1,1) = {"
d
c
S
N
t
u
h
o
y
"}
(3,1,1) = {"
d
g
Q
S
T
S
X
J
m
"}
(4,1,1) = {"
d
A
Q
S
T
S
O
J
m
"}
(5,1,1) = {"
d
n
x
s
t
S
f
v
y
"}
(6,1,1) = {"
y
y
r
y
t
H
H
y
y
"}
